Código,Unidade Territorial,UF,Referência,Quantidade de pessoas com perfil saúde (crianças menores de 7 anos e mulheres),Quantidade de pessoas acompanhadas pela saúde,Percentual de acompanhamento na saúde,Quantidade de pessoas com perfil saúde não acompanhadas,Quantidade de pessoas com perfil saúde sem informação nas condicionalidades de saúde,Total de crianças com perfil saúde (com crianças menores de 7 anos),Total de crianças acompanhadas,Percentual de crianças acompanhadas,Total de crianças com vacinação em dia,Total de crianças com dados nutricionais coletados,Total de mulheres com perfil saúde,Total de mulheres acompanhadas,Percentual de mulheres acompanhadas,Total de gestantes identificadas,Total de gestantes que estão realizando o pré natal
120001,ACRELÂNDIA,AC,06/2022,3913,2869,"73,32",,1044,1157,598,"51,69",598,598,2756,2271,"82,40",103,103
120001,ACRELÂNDIA,AC,12/2022,4356,4115,"94,47",,241,1229,1097,"89,26",1097,1097,3127,3018,"96,51",131,131
120005,ASSIS BRASIL,AC,12/2022,3663,2723,"74,34",1,939,1239,663,"53,51",662,663,2424,2060,"84,98",128,128
120005,ASSIS BRASIL,AC,06/2022,3546,2399,"67,65",,1147,1272,579,"45,52",579,579,2274,1820,"80,04",91,91
120010,BRASILÉIA,AC,06/2022,7474,6177,"82,65",22,1275,2093,1441,"68,85",1441,1441,5381,4736,"88,01",253,253
120010,BRASILÉIA,AC,12/2022,7951,6686,"84,09",3,1262,2136,1477,"69,15",1476,1477,5815,5209,"89,58",232,232
120013,BUJARI,AC,12/2022,3734,3131,"83,85",,603,987,672,"68,09",672,672,2747,2459,"89,52",74,74
120013,BUJARI,AC,06/2022,3619,2931,"80,99",3,685,1007,666,"66,14",664,666,2612,2265,"86,72",82,82
120017,CAPIXABA,AC,12/2022,3573,2867,"80,24",9,697,1009,537,"53,22",537,537,2564,2330,"90,87",91,91
120017,CAPIXABA,AC,06/2022,3406,2535,"74,43",23,848,1014,463,"45,66",462,463,2392,2072,"86,62",91,91
120020,CRUZEIRO DO SUL,AC,12/2022,27944,22290,"79,77",524,5130,7121,3948,"55,44",3944,3948,20823,18342,"88,09",730,729
120020,CRUZEIRO DO SUL,AC,06/2022,26394,15423,"58,43",461,10510,7693,1133,"14,73",1133,1133,18701,14290,"76,41",638,638
120025,EPITACIOLÂNDIA,AC,06/2022,4445,3827,"86,10",80,538,1221,864,"70,76",864,864,3224,2963,"91,90",98,98
120025,EPITACIOLÂNDIA,AC,12/2022,4882,4648,"95,21",100,134,1217,1086,"89,24",1084,1085,3665,3562,"97,19",117,117
120030,FEIJÓ,AC,12/2022,11974,8451,"70,58",303,3220,3906,2295,"58,76",2295,2290,8068,6156,"76,30",366,366
120030,FEIJÓ,AC,06/2022,11566,7122,"61,58",214,4230,3912,1844,"47,14",1844,1844,7654,5278,"68,96",294,294
120032,JORDÃO,AC,06/2022,3747,1898,"50,65",,1849,1567,435,"27,76",435,435,2180,1463,"67,11",66,66
120032,JORDÃO,AC,12/2022,4006,2858,"71,34",,1148,1538,832,"54,10",832,832,2468,2026,"82,09",129,128
120033,MÂNCIO LIMA,AC,12/2022,7580,5934,"78,28",130,1516,2148,1226,"57,08",1225,1226,5432,4708,"86,67",179,179
120033,MÂNCIO LIMA,AC,06/2022,7331,5132,"70,00",89,2110,2233,950,"42,54",947,950,5098,4182,"82,03",189,189
120034,MANOEL URBANO,AC,12/2022,4356,3338,"76,63",174,844,1311,738,"56,29",728,738,3045,2600,"85,39",105,105
120034,MANOEL URBANO,AC,06/2022,3988,2573,"64,52",,1415,1372,488,"35,57",488,488,2616,2085,"79,70",97,97
120035,MARECHAL THAUMATURGO,AC,06/2022,7493,6689,"89,27",112,692,2140,1683,"78,64",1683,1683,5353,5006,"93,52",194,193
120035,MARECHAL THAUMATURGO,AC,12/2022,7658,6824,"89,11",150,684,2165,1714,"79,17",1700,1714,5493,5110,"93,03",211,211
120038,PLÁCIDO DE CASTRO,AC,12/2022,4368,3535,"80,93",6,827,1214,719,"59,23",719,719,3154,2816,"89,28",118,118
120038,PLÁCIDO DE CASTRO,AC,06/2022,4061,3374,"83,08",2,685,1101,696,"63,22",696,696,2960,2678,"90,47",97,97
120039,PORTO WALTER,AC,12/2022,4284,3758,"87,72",256,270,1341,1017,"75,84",1017,1017,2943,2741,"93,14",116,116
120039,PORTO WALTER,AC,06/2022,4171,3640,"87,27",113,418,1334,1014,"76,01",1014,1014,2837,2626,"92,56",106,106
120040,RIO BRANCO,AC,12/2022,68072,46793,"68,74",46,21233,18324,8267,"45,12",8089,8265,49748,38526,"77,44",1908,1899
120040,RIO BRANCO,AC,06/2022,63084,40582,"64,33",15,22487,18280,7397,"40,46",7309,7394,44804,33185,"74,07",1637,1634
120042,RODRIGUES ALVES,AC,06/2022,5646,3797,"67,25",2,1847,1822,704,"38,64",704,704,3824,3093,"80,88",180,180
120042,RODRIGUES ALVES,AC,12/2022,5704,4431,"77,68",8,1265,1700,912,"53,65",912,912,4004,3519,"87,89",180,180
120043,SANTA ROSA DO PURUS,AC,06/2022,2807,2094,"74,60",5,708,1165,766,"65,75",766,766,1642,1328,"80,88",86,86
120043,SANTA ROSA DO PURUS,AC,12/2022,2717,2175,"80,05",12,530,1047,750,"71,63",750,750,1670,1425,"85,33",71,71
120045,SENADOR GUIOMARD,AC,12/2022,7562,5022,"66,41",26,2514,1945,614,"31,57",613,614,5617,4408,"78,48",209,209
120045,SENADOR GUIOMARD,AC,06/2022,7625,4602,"60,35",2,3021,2130,568,"26,67",567,568,5495,4034,"73,41",207,207
120050,SENA MADUREIRA,AC,12/2022,16552,12810,"77,39",3,3739,4503,2436,"54,10",2418,2420,12049,10374,"86,10",476,475
120050,SENA MADUREIRA,AC,06/2022,16512,12901,"78,13",,3611,4674,2744,"58,71",2744,2744,11838,10157,"85,80",419,419
120060,TARAUACÁ,AC,12/2022,18835,14309,"75,97",15,4511,5881,3094,"52,61",3072,3093,12954,11215,"86,58",564,563
120060,TARAUACÁ,AC,06/2022,18624,13155,"70,63",21,5448,6193,3010,"48,60",2990,3009,12431,10145,"81,61",585,584
120070,XAPURI,AC,06/2022,5003,3681,"73,58",27,1295,1578,788,"49,94",788,788,3425,2893,"84,47",132,130
120070,XAPURI,AC,12/2022,5217,4394,"84,22",43,780,1566,1100,"70,24",1098,1100,3651,3294,"90,22",143,142
120080,PORTO ACRE,AC,12/2022,6881,5570,"80,95",18,1293,1884,1218,"64,65",1205,1218,4997,4352,"87,09",182,180
120080,PORTO ACRE,AC,06/2022,6576,4914,"74,73",6,1656,1918,1072,"55,89",1064,1072,4658,3842,"82,48",192,190
270010,ÁGUA BRANCA,AL,06/2022,6964,5854,"84,06",204,906,1773,1030,"58,09",1030,1030,5191,4824,"92,93",176,176
270010,ÁGUA BRANCA,AL,12/2022,6854,5671,"82,74",95,1088,1706,920,"53,93",920,920,5148,4751,"92,29",154,154
270020,ANADIA,AL,12/2022,5368,4688,"87,33",102,578,1263,832,"65,87",832,832,4105,3856,"93,93",136,136
270020,ANADIA,AL,06/2022,5310,4461,"84,01",43,806,1288,776,"60,25",776,776,4022,3685,"91,62",106,106
270030,ARAPIRACA,AL,06/2022,39705,24682,"62,16",132,14891,9895,2002,"20,23",2002,2002,29810,22680,"76,08",997,997
270030,ARAPIRACA,AL,12/2022,41025,30287,"73,83",38,10700,9521,3450,"36,24",3450,3450,31504,26837,"85,19",1024,1024
270040,ATALAIA,AL,12/2022,14796,11702,"79,09",406,2688,3596,1711,"47,58",1701,1615,11200,9991,"89,21",419,419
270040,ATALAIA,AL,06/2022,14526,8702,"59,91",3,5821,3722,188,"5,05",188,188,10804,8514,"78,80",411,411
270050,BARRA DE SANTO ANTÔNIO,AL,06/2022,6971,5443,"78,08",48,1480,1889,892,"47,22",892,892,5082,4551,"89,55",235,235
270050,BARRA DE SANTO ANTÔNIO,AL,12/2022,7016,5661,"80,69",45,1310,1773,892,"50,31",892,892,5243,4769,"90,96",174,174
270060,BARRA DE SÃO MIGUEL,AL,06/2022,2978,2515,"84,45",24,439,864,563,"65,16",563,563,2114,1952,"92,34",85,85
270060,BARRA DE SÃO MIGUEL,AL,12/2022,3004,2596,"86,42",77,331,838,575,"68,62",575,575,2166,2021,"93,31",92,92
270070,BATALHA,AL,06/2022,6509,5059,"77,72",185,1265,1746,763,"43,70",763,762,4763,4296,"90,20",163,163
270070,BATALHA,AL,12/2022,6707,5853,"87,27",333,521,1676,1130,"67,42",1130,1129,5031,4723,"93,88",165,165
270080,BELÉM,AL,06/2022,1783,1567,"87,89",75,141,451,310,"68,74",310,310,1332,1257,"94,37",50,50
270080,BELÉM,AL,12/2022,1787,1680,"94,01",37,70,425,353,"83,06",353,353,1362,1327,"97,43",46,46
270090,BELO MONTE,AL,12/2022,2593,2420,"93,33",161,12,639,518,"81,06",518,517,1954,1902,"97,34",90,90
270090,BELO MONTE,AL,06/2022,2594,2301,"88,70",82,211,651,448,"68,82",448,444,1943,1853,"95,37",87,87
270100,BOCA DA MATA,AL,12/2022,8231,7409,"90,01",102,720,1768,1313,"74,26",1313,1313,6463,6096,"94,32",182,182
270100,BOCA DA MATA,AL,06/2022,8065,7112,"88,18",83,870,1836,1304,"71,02",1304,1304,6229,5808,"93,24",214,214
270110,BRANQUINHA,AL,06/2022,4053,3625,"89,44",179,249,1109,817,"73,67",817,817,2944,2808,"95,38",119,119
270110,BRANQUINHA,AL,12/2022,4166,3882,"93,18",,284,1100,886,"80,55",886,886,3066,2996,"97,72",150,150
270120,CACIMBINHAS,AL,06/2022,3413,2576,"75,48",,837,781,215,"27,53",215,215,2632,2361,"89,70",84,84
270120,CACIMBINHAS,AL,12/2022,3430,2891,"84,29",,539,763,422,"55,31",422,422,2667,2469,"92,58",93,93
270130,CAJUEIRO,AL,12/2022,6970,5409,"77,60",474,1087,1845,885,"47,97",885,885,5125,4524,"88,27",203,203
270130,CAJUEIRO,AL,06/2022,6913,5057,"73,15",21,1835,1878,753,"40,10",753,753,5035,4304,"85,48",218,218
270135,CAMPESTRE,AL,06/2022,2742,2146,"78,26",,596,705,371,"52,62",371,371,2037,1775,"87,14",72,72
270135,CAMPESTRE,AL,12/2022,2725,2288,"83,96",2,435,674,441,"65,43",441,441,2051,1847,"90,05",73,73
270140,CAMPO ALEGRE,AL,12/2022,11217,10692,"95,32",3,522,2685,2292,"85,36",2292,2292,8532,8400,"98,45",298,298
270140,CAMPO ALEGRE,AL,06/2022,11276,10690,"94,80",,586,2726,2242,"82,25",2242,2242,8550,8448,"98,81",343,343
270150,CAMPO GRANDE,AL,12/2022,4268,3634,"85,15",125,509,975,580,"59,49",580,580,3293,3054,"92,74",122,122
270150,CAMPO GRANDE,AL,06/2022,4358,3723,"85,43",90,545,1030,651,"63,20",651,651,3328,3072,"92,31",125,125
270160,CANAPI,AL,06/2022,7685,5121,"66,64",28,2536,2012,387,"19,23",386,386,5673,4734,"83,45",201,201
270160,CANAPI,AL,12/2022,7553,5484,"72,61",204,1865,1863,516,"27,70",516,516,5690,4968,"87,31",208,208
270170,CAPELA,AL,06/2022,4729,3602,"76,17",7,1120,1176,364,"30,95",364,364,3553,3238,"91,13",134,134
270170,CAPELA,AL,12/2022,4738,4111,"86,77",2,625,1138,680,"59,75",680,680,3600,3431,"95,31",132,132
270180,CARNEIROS,AL,06/2022,3906,3092,"79,16",,814,1119,568,"50,76",568,568,2787,2524,"90,56",130,130
270180,CARNEIROS,AL,12/2022,3815,3122,"81,83",1,692,1040,569,"54,71",569,569,2775,2553,"92,00",115,115
270190,CHÃ PRETA,AL,06/2022,2738,2203,"80,46",,535,709,366,"51,62",366,366,2029,1837,"90,54",61,61
270190,CHÃ PRETA,AL,12/2022,2858,2544,"89,01",16,298,694,509,"73,34",509,509,2164,2035,"94,04",99,99
270200,COITÉ DO NÓIA,AL,06/2022,3506,3123,"89,08",,383,839,614,"73,18",614,614,2667,2509,"94,08",104,104
270200,COITÉ DO NÓIA,AL,12/2022,3602,3195,"88,70",2,405,869,603,"69,39",603,603,2733,2592,"94,84",125,125
270210,COLÔNIA LEOPOLDINA,AL,06/2022,7214,5061,"70,16",,2153,1905,536,"28,14",536,536,5309,4525,"85,23",182,182
270210,COLÔNIA LEOPOLDINA,AL,12/2022,7121,4588,"64,43",,2533,1839,160,"8,70",160,160,5282,4428,"83,83",204,204
270220,COQUEIRO SECO,AL,12/2022,1811,1371,"75,70",,440,445,185,"41,57",185,185,1366,1186,"86,82",45,45
270220,COQUEIRO SECO,AL,06/2022,1724,1268,"73,55",,456,440,156,"35,45",156,156,1284,1112,"86,60",46,46
270230,CORURIPE,AL,12/2022,14494,13963,"96,34",3,528,3710,3374,"90,94",3373,3217,10784,10589,"98,19",423,423
270230,CORURIPE,AL,06/2022,13882,12389,"89,25",12,1481,3684,2678,"72,69",2675,2322,10198,9711,"95,22",394,393
270235,CRAÍBAS,AL,12/2022,9435,8837,"93,66",5,593,2384,1976,"82,89",1976,1976,7051,6861,"97,31",313,313
270235,CRAÍBAS,AL,06/2022,9080,7974,"87,82",17,1089,2406,1693,"70,37",1693,1693,6674,6281,"94,11",314,314
270240,DELMIRO GOUVEIA,AL,06/2022,15100,12289,"81,38",447,2364,3976,2281,"57,37",2278,2281,11124,10008,"89,97",357,357
270240,DELMIRO GOUVEIA,AL,12/2022,15451,12634,"81,77",1427,1390,3850,2120,"55,06",2119,2120,11601,10514,"90,63",417,417
270250,DOIS RIACHOS,AL,12/2022,3889,3577,"91,98",20,292,866,634,"73,21",634,634,3023,2943,"97,35",123,123
270250,DOIS RIACHOS,AL,06/2022,3553,2470,"69,52",1,1082,853,21,"2,46",21,21,2700,2449,"90,70",115,115
270255,ESTRELA DE ALAGOAS,AL,06/2022,5236,4684,"89,46",143,409,1242,916,"73,75",916,915,3994,3768,"94,34",147,147
270255,ESTRELA DE ALAGOAS,AL,12/2022,5353,5021,"93,80",243,89,1205,993,"82,41",993,991,4148,4028,"97,11",155,155
270260,FEIRA GRANDE,AL,12/2022,8346,7595,"91,00",,751,1902,1511,"79,44",1511,1511,6444,6084,"94,41",227,227
270260,FEIRA GRANDE,AL,06/2022,7650,4503,"58,86",,3147,1979,245,"12,38",245,245,5671,4258,"75,08",231,231
270270,FELIZ DESERTO,AL,12/2022,1406,990,"70,41",,416,406,50,"12,32",50,50,1000,940,"94,00",30,30
270270,FELIZ DESERTO,AL,06/2022,1443,997,"69,09",,446,415,40,"9,64",40,40,1028,957,"93,09",43,43
270280,FLEXEIRAS,AL,12/2022,4491,3546,"78,96",,945,1312,692,"52,74",692,692,3179,2854,"89,78",124,124
270280,FLEXEIRAS,AL,06/2022,4522,3564,"78,81",,958,1331,718,"53,94",718,718,3191,2846,"89,19",128,128
270290,GIRAU DO PONCIANO,AL,06/2022,12496,9350,"74,82",354,2792,3202,1141,"35,63",1141,1141,9294,8209,"88,33",389,389
270290,GIRAU DO PONCIANO,AL,12/2022,12803,10147,"79,25",303,2353,3141,1389,"44,22",1388,1388,9662,8758,"90,64",399,399
270300,IBATEGUARA,AL,12/2022,5479,4980,"90,89",2,497,1463,1214,"82,98",1214,1214,4016,3766,"93,77",171,171
270300,IBATEGUARA,AL,06/2022,5516,4810,"87,20",15,691,1510,1113,"73,71",1113,1113,4006,3697,"92,29",155,155
270310,IGACI,AL,12/2022,9360,8743,"93,41",130,487,2158,1796,"83,23",1796,1796,7202,6947,"96,46",199,199
270310,IGACI,AL,06/2022,9487,8834,"93,12",87,566,2238,1855,"82,89",1855,1855,7249,6979,"96,28",183,183
270320,IGREJA NOVA,AL,06/2022,7211,6573,"91,15",139,499,1712,1264,"73,83",1259,1254,5499,5309,"96,54",156,156
270320,IGREJA NOVA,AL,12/2022,7001,6244,"89,19",153,604,1603,1065,"66,44",1065,1065,5398,5179,"95,94",155,155
270330,INHAPI,AL,06/2022,6640,5481,"82,55",49,1110,1776,1016,"57,21",1005,1016,4864,4465,"91,80",223,223
270330,INHAPI,AL,12/2022,6770,5757,"85,04",50,963,1737,1060,"61,02",1060,1060,5033,4697,"93,32",231,231
270340,JACARÉ DOS HOMENS,AL,12/2022,2127,1927,"90,60",45,155,557,410,"73,61",410,410,1570,1517,"96,62",70,70
270340,JACARÉ DOS HOMENS,AL,06/2022,2086,1858,"89,07",33,195,554,393,"70,94",393,393,1532,1465,"95,63",62,62
270350,JACUÍPE,AL,06/2022,2077,1811,"87,19",6,260,506,338,"66,80",338,338,1571,1473,"93,76",48,48
270350,JACUÍPE,AL,12/2022,2122,2044,"96,32",1,77,493,449,"91,08",449,449,1629,1595,"97,91",52,52
270360,JAPARATINGA,AL,12/2022,3820,2763,"72,33",,1057,1008,336,"33,33",336,336,2812,2427,"86,31",103,103
270360,JAPARATINGA,AL,06/2022,3728,2581,"69,23",4,1143,1024,348,"33,98",348,348,2704,2233,"82,58",94,94
270370,JARAMATAIA,AL,12/2022,2088,1993,"95,45",,95,519,453,"87,28",453,453,1569,1540,"98,15",52,52
270370,JARAMATAIA,AL,06/2022,1997,1914,"95,84",1,82,546,486,"89,01",486,486,1451,1428,"98,41",60,60
270375,JEQUIÁ DA PRAIA,AL,06/2022,4052,3584,"88,45",94,374,1027,692,"67,38",692,692,3025,2892,"95,60",102,102
270375,JEQUIÁ DA PRAIA,AL,12/2022,4185,3827,"91,45",81,277,1015,764,"75,27",764,764,3170,3063,"96,62",111,111
270380,JOAQUIM GOMES,AL,06/2022,7871,6146,"78,08",8,1717,2114,955,"45,18",955,955,5757,5191,"90,17",183,183
270380,JOAQUIM GOMES,AL,12/2022,7784,6496,"83,45",20,1268,2053,1217,"59,28",1217,1217,5731,5279,"92,11",179,179
270390,JUNDIÁ,AL,06/2022,1582,1303,"82,36",,279,415,209,"50,36",209,209,1167,1094,"93,74",46,46
270390,JUNDIÁ,AL,12/2022,1527,1238,"81,07",,289,393,188,"47,84",188,188,1134,1050,"92,59",43,43
270400,JUNQUEIRO,AL,06/2022,8491,7367,"86,76",1,1123,2050,1304,"63,61",1304,1304,6441,6063,"94,13",272,272
270400,JUNQUEIRO,AL,12/2022,8422,7220,"85,73",4,1198,1985,1234,"62,17",1234,1234,6437,5986,"92,99",271,271
270410,LAGOA DA CANOA,AL,06/2022,6908,6500,"94,09",196,212,1738,1499,"86,25",1499,1499,5170,5001,"96,73",202,202
270410,LAGOA DA CANOA,AL,12/2022,6872,6482,"94,32",189,201,1652,1423,"86,14",1423,1423,5220,5059,"96,92",166,166
270420,LIMOEIRO DE ANADIA,AL,12/2022,9305,8403,"90,31",254,648,2186,1597,"73,06",1597,1595,7119,6806,"95,60",268,268
270420,LIMOEIRO DE ANADIA,AL,06/2022,9019,8131,"90,15",231,657,2223,1619,"72,83",1619,1613,6796,6512,"95,82",272,272
270430,MACEIÓ,AL,06/2022,117801,49236,"41,80",6,68559,34728,4073,"11,73",4072,4073,83073,45163,"54,37",2429,2429
270430,MACEIÓ,AL,12/2022,121857,56639,"46,48",5,65213,34294,5795,"16,90",5795,5794,87563,50844,"58,07",2559,2559
270440,MAJOR ISIDORO,AL,06/2022,6603,5316,"80,51",304,983,1623,828,"51,02",828,828,4980,4488,"90,12",219,219
270440,MAJOR ISIDORO,AL,12/2022,6586,5278,"80,14",303,1005,1558,723,"46,41",723,723,5028,4555,"90,59",179,179
270450,MARAGOGI,AL,06/2022,10881,6849,"62,94",17,4015,3121,363,"11,63",363,363,7760,6486,"83,58",279,279
270450,MARAGOGI,AL,12/2022,11665,8925,"76,51",119,2621,3120,1271,"40,74",1271,1271,8545,7654,"89,57",321,321
270460,MARAVILHA,AL,06/2022,4052,3176,"78,38",189,687,1027,467,"45,47",459,462,3025,2709,"89,55",121,121
270460,MARAVILHA,AL,12/2022,4153,3403,"81,94",150,600,1016,514,"50,59",514,488,3137,2889,"92,09",121,121
270470,MARECHAL DEODORO,AL,12/2022,17512,17010,"97,13",498,4,4186,3897,"93,10",3896,2335,13326,13113,"98,40",385,385
270470,MARECHAL DEODORO,AL,06/2022,16925,16157,"95,46",768,,4188,3746,"89,45",3745,2539,12737,12411,"97,44",372,372
270480,MARIBONDO,AL,06/2022,3753,2441,"65,04",,1312,991,73,"7,37",73,73,2762,2368,"85,73",104,104
270480,MARIBONDO,AL,12/2022,3830,2584,"67,47",,1246,975,97,"9,95",97,97,2855,2487,"87,11",88,88
270490,MAR VERMELHO,AL,06/2022,1245,1113,"89,40",60,72,284,209,"73,59",209,209,961,904,"94,07",27,27
270490,MAR VERMELHO,AL,12/2022,1222,1120,"91,65",44,58,271,204,"75,28",204,204,951,916,"96,32",34,34
270500,MATA GRANDE,AL,06/2022,7453,6801,"91,25",514,138,1881,1457,"77,46",1457,1457,5572,5344,"95,91",222,222
270500,MATA GRANDE,AL,12/2022,7394,6771,"91,57",559,64,1811,1439,"79,46",1439,1439,5583,5332,"95,50",230,230
270510,MATRIZ DE CAMARAGIBE,AL,12/2022,8053,6439,"79,96",,1614,2057,1043,"50,70",1043,1043,5996,5396,"89,99",260,260
270510,MATRIZ DE CAMARAGIBE,AL,06/2022,7808,6635,"84,98",,1173,1976,1255,"63,51",1255,1255,5832,5380,"92,25",233,233
270520,MESSIAS,AL,12/2022,4651,3166,"68,07",,1485,1343,417,"31,05",417,417,3308,2749,"83,10",142,142
270520,MESSIAS,AL,06/2022,4519,3076,"68,07",,1443,1310,408,"31,15",408,408,3209,2668,"83,14",155,155
270530,MINADOR DO NEGRÃO,AL,12/2022,1632,1421,"87,07",33,178,375,238,"63,47",238,237,1257,1183,"94,11",48,48
270530,MINADOR DO NEGRÃO,AL,06/2022,1579,1391,"88,09",50,138,352,252,"71,59",252,251,1227,1139,"92,83",47,47
270540,MONTEIRÓPOLIS,AL,12/2022,3063,2601,"84,92",,462,743,399,"53,70",399,399,2320,2202,"94,91",74,74
270540,MONTEIRÓPOLIS,AL,06/2022,3107,2623,"84,42",,484,783,447,"57,09",447,447,2324,2176,"93,63",95,95
270550,MURICI,AL,12/2022,9066,7013,"77,35",784,1269,2658,1391,"52,33",1391,1391,6408,5622,"87,73",286,286
270550,MURICI,AL,06/2022,9221,6818,"73,94",82,2321,2765,1228,"44,41",1228,1228,6456,5590,"86,59",235,235
270560,NOVO LINO,AL,12/2022,3676,2531,"68,85",,1145,941,182,"19,34",182,182,2735,2349,"85,89",105,105
270560,NOVO LINO,AL,06/2022,3724,2602,"69,87",,1122,955,262,"27,43",262,262,2769,2340,"84,51",112,112
270570,OLHO D´ÁGUA DAS FLORES,AL,12/2022,6761,5899,"87,25",158,704,1643,1058,"64,39",1058,1038,5118,4841,"94,59",163,163
270570,OLHO D´ÁGUA DAS FLORES,AL,06/2022,6357,5463,"85,94",87,807,1546,908,"58,73",908,906,4811,4555,"94,68",142,142
270580,OLHO D´ÁGUA DO CASADO,AL,06/2022,3463,2287,"66,04",,1176,952,83,"8,72",83,83,2511,2204,"87,77",123,123
270580,OLHO D´ÁGUA DO CASADO,AL,12/2022,3468,2376,"68,51",1,1091,928,84,"9,05",84,84,2540,2292,"90,24",133,133
270590,OLHO D´ÁGUA GRANDE,AL,12/2022,2462,2098,"85,22",42,322,629,408,"64,86",408,408,1833,1690,"92,20",71,71
270590,OLHO D´ÁGUA GRANDE,AL,06/2022,2591,2227,"85,95",170,194,676,470,"69,53",470,470,1915,1757,"91,75",82,82
270600,OLIVENÇA,AL,12/2022,4403,3600,"81,76",53,750,1145,611,"53,36",611,611,3258,2989,"91,74",143,143
270600,OLIVENÇA,AL,06/2022,4463,3648,"81,74",69,746,1211,695,"57,39",695,695,3252,2953,"90,81",130,130
270610,OURO BRANCO,AL,12/2022,4737,3990,"84,23",,747,1153,702,"60,88",702,702,3584,3288,"91,74",154,154
270610,OURO BRANCO,AL,06/2022,4699,3878,"82,53",,821,1175,676,"57,53",676,676,3524,3202,"90,86",149,149
270620,PALESTINA,AL,12/2022,1942,1667,"85,84",,275,502,291,"57,97",291,291,1440,1376,"95,56",83,83
270620,PALESTINA,AL,06/2022,1918,1641,"85,56",3,274,495,319,"64,44",319,319,1423,1322,"92,90",59,59
270630,PALMEIRA DOS ÍNDIOS,AL,06/2022,20712,16540,"79,86",296,3876,4904,2511,"51,20",2511,2510,15808,14029,"88,75",513,513
270630,PALMEIRA DOS ÍNDIOS,AL,12/2022,21142,17429,"82,44",480,3233,4552,2417,"53,10",2416,2417,16590,15012,"90,49",523,523
270640,PÃO DE AÇÚCAR,AL,12/2022,8023,7400,"92,23",197,426,1940,1463,"75,41",1463,1463,6083,5937,"97,60",242,242
270640,PÃO DE AÇÚCAR,AL,06/2022,8006,7339,"91,67",125,542,1968,1480,"75,20",1480,1480,6038,5859,"97,04",251,251
270642,PARICONHA,AL,12/2022,3946,3625,"91,87",36,285,930,760,"81,72",760,760,3016,2865,"94,99",60,60
270642,PARICONHA,AL,06/2022,3977,3437,"86,42",255,285,991,706,"71,24",706,706,2986,2731,"91,46",84,84
270644,PARIPUEIRA,AL,12/2022,4784,3564,"74,50",,1220,1280,572,"44,69",572,572,3504,2992,"85,39",168,168
270644,PARIPUEIRA,AL,06/2022,4607,3283,"71,26",54,1270,1314,569,"43,30",569,569,3293,2714,"82,42",147,147
270650,PASSO DE CAMARAGIBE,AL,06/2022,4874,3810,"78,17",23,1041,1234,555,"44,98",555,555,3640,3255,"89,42",108,108
270650,PASSO DE CAMARAGIBE,AL,12/2022,5025,3779,"75,20",,1246,1244,442,"35,53",442,442,3781,3337,"88,26",120,120
270660,PAULO JACINTO,AL,06/2022,2319,1913,"82,49",37,369,557,296,"53,14",296,296,1762,1617,"91,77",52,52
270660,PAULO JACINTO,AL,12/2022,2337,1977,"84,60",25,335,563,315,"55,95",315,315,1774,1662,"93,69",69,69
270670,PENEDO,AL,12/2022,20627,17355,"84,14",390,2882,4869,2748,"56,44",2748,2748,15758,14607,"92,70",538,538
270670,PENEDO,AL,06/2022,20104,16443,"81,79",515,3146,4975,2584,"51,94",2584,2584,15129,13859,"91,61",492,492
270680,PIAÇABUÇU,AL,12/2022,7223,6019,"83,33",,1204,1848,1105,"59,79",1105,1105,5375,4914,"91,42",187,187
270680,PIAÇABUÇU,AL,06/2022,7348,6042,"82,23",,1306,1951,1123,"57,56",1123,1123,5397,4919,"91,14",191,191
270690,PILAR,AL,06/2022,12229,8628,"70,55",143,3458,3316,846,"25,51",846,846,8913,7782,"87,31",362,362
270690,PILAR,AL,12/2022,13094,11541,"88,14",837,716,3230,2042,"63,22",2042,2042,9864,9499,"96,30",413,413
270700,PINDOBA,AL,12/2022,739,576,"77,94",,163,168,67,"39,88",67,67,571,509,"89,14",29,29
270700,PINDOBA,AL,06/2022,712,555,"77,95",,157,164,75,"45,73",75,75,548,480,"87,59",23,23
270710,PIRANHAS,AL,12/2022,8471,5888,"69,51",,2583,2169,167,"7,70",167,167,6302,5721,"90,78",282,282
270710,PIRANHAS,AL,06/2022,8559,5853,"68,38",,2706,2219,180,"8,11",180,180,6340,5673,"89,48",317,317
270720,POÇO DAS TRINCHEIRAS,AL,12/2022,5160,4324,"83,80",160,676,1267,727,"57,38",725,727,3893,3597,"92,40",184,184
270720,POÇO DAS TRINCHEIRAS,AL,06/2022,5292,4337,"81,95",52,903,1371,746,"54,41",737,745,3921,3591,"91,58",160,160
270730,PORTO CALVO,AL,06/2022,9749,6071,"62,27",,3678,2553,211,"8,26",211,211,7196,5860,"81,43",253,253
270730,PORTO CALVO,AL,12/2022,10189,8799,"86,36",,1390,2496,1707,"68,39",1707,1707,7693,7092,"92,19",237,237
270740,PORTO DE PEDRAS,AL,12/2022,3281,3012,"91,80",160,109,876,717,"81,85",717,717,2405,2295,"95,43",88,88
270740,PORTO DE PEDRAS,AL,06/2022,3273,2970,"90,74",138,165,895,728,"81,34",728,725,2378,2242,"94,28",91,91
270750,PORTO REAL DO COLÉGIO,AL,06/2022,7686,5171,"67,28",1,2514,1968,307,"15,60",307,307,5718,4864,"85,06",175,175
270750,PORTO REAL DO COLÉGIO,AL,12/2022,7661,5504,"71,84",44,2113,1824,343,"18,80",343,343,5837,5161,"88,42",184,184
270760,QUEBRANGULO,AL,12/2022,4304,2956,"68,68",,1348,1034,62,"6,00",62,62,3270,2894,"88,50",109,109
270760,QUEBRANGULO,AL,06/2022,4404,3168,"71,93",31,1205,1118,240,"21,47",240,240,3286,2928,"89,11",123,123
270770,RIO LARGO,AL,06/2022,22986,14534,"63,23",9,8443,6105,1197,"19,61",1187,1184,16881,13337,"79,01",681,681
270770,RIO LARGO,AL,12/2022,24964,17038,"68,25",21,7905,6262,1189,"18,99",1189,1189,18702,15849,"84,74",729,729
270780,ROTEIRO,AL,06/2022,2902,2612,"90,01",64,226,773,576,"74,51",576,576,2129,2036,"95,63",100,100
270780,ROTEIRO,AL,12/2022,2974,2718,"91,39",,256,766,602,"78,59",602,602,2208,2116,"95,83",95,95
270790,SANTA LUZIA DO NORTE,AL,12/2022,2340,2056,"87,86",79,205,592,388,"65,54",388,388,1748,1668,"95,42",65,65
270790,SANTA LUZIA DO NORTE,AL,06/2022,2282,1745,"76,47",6,531,591,186,"31,47",186,186,1691,1559,"92,19",63,63
270800,SANTANA DO IPANEMA,AL,12/2022,15789,13375,"84,71",403,2011,3805,2231,"58,63",2231,2230,11984,11144,"92,99",446,446
270800,SANTANA DO IPANEMA,AL,06/2022,15582,10831,"69,51",7,4744,4008,594,"14,82",594,594,11574,10237,"88,45",478,478
270810,SANTANA DO MUNDAÚ,AL,12/2022,4034,3744,"92,81",66,224,1034,839,"81,14",838,833,3000,2905,"96,83",131,131
270810,SANTANA DO MUNDAÚ,AL,06/2022,4011,3748,"93,44",62,201,1033,837,"81,03",837,835,2978,2911,"97,75",123,123
270820,SÃO BRÁS,AL,12/2022,2279,2025,"88,85",50,204,535,381,"71,21",381,381,1744,1644,"94,27",74,74
270820,SÃO BRÁS,AL,06/2022,2216,1918,"86,55",44,254,540,350,"64,81",350,350,1676,1568,"93,56",69,69
270830,SÃO JOSÉ DA LAJE,AL,12/2022,7037,6146,"87,34",19,872,1898,1278,"67,33",1278,1278,5139,4868,"94,73",211,211
270830,SÃO JOSÉ DA LAJE,AL,06/2022,6950,5127,"73,77",,1823,1922,457,"23,78",457,457,5028,4670,"92,88",194,194
270840,SÃO JOSÉ DA TAPERA,AL,12/2022,13172,12198,"92,61",531,443,3276,2667,"81,41",2667,2667,9896,9531,"96,31",381,381
270840,SÃO JOSÉ DA TAPERA,AL,06/2022,13357,12191,"91,27",577,589,3453,2742,"79,41",2742,2742,9904,9449,"95,41",359,359
270850,SÃO LUÍS DO QUITUNDE,AL,06/2022,11433,6761,"59,14",,4672,3097,172,"5,55",172,172,8336,6589,"79,04",256,256
270850,SÃO LUÍS DO QUITUNDE,AL,12/2022,11431,6924,"60,57",,4507,2971,172,"5,79",172,172,8460,6752,"79,81",279,279
270860,SÃO MIGUEL DOS CAMPOS,AL,12/2022,16690,14669,"87,89",59,1962,3846,2826,"73,48",2826,2826,12844,11843,"92,21",458,458
270860,SÃO MIGUEL DOS CAMPOS,AL,06/2022,16619,14845,"89,33",136,1638,3939,2972,"75,45",2972,2972,12680,11873,"93,64",450,450
270870,SÃO MIGUEL DOS MILAGRES,AL,12/2022,2691,2123,"78,89",,568,733,358,"48,84",358,358,1958,1765,"90,14",62,62
270870,SÃO MIGUEL DOS MILAGRES,AL,06/2022,2741,2226,"81,21",,515,756,407,"53,84",407,407,1985,1819,"91,64",67,67
270880,SÃO SEBASTIÃO,AL,06/2022,12061,11372,"94,29",,689,2832,2414,"85,24",2414,2414,9229,8958,"97,06",290,290
270880,SÃO SEBASTIÃO,AL,12/2022,12193,11705,"96,00",,488,2768,2477,"89,49",2477,2477,9425,9228,"97,91",301,301
270890,SATUBA,AL,12/2022,3954,2446,"61,86",,1508,1059,268,"25,31",268,266,2895,2178,"75,23",86,86
270890,SATUBA,AL,06/2022,3728,1960,"52,58",,1768,1054,138,"13,09",138,138,2674,1822,"68,14",84,84
270895,SENADOR RUI PALMEIRA,AL,06/2022,5266,4051,"76,93",,1215,1345,558,"41,49",558,558,3921,3493,"89,08",124,124
270895,SENADOR RUI PALMEIRA,AL,12/2022,5339,4328,"81,06",,1011,1271,570,"44,85",570,570,4068,3758,"92,38",180,180
270900,TANQUE D´ARCA,AL,06/2022,1864,1763,"94,58",51,50,400,342,"85,50",342,342,1464,1421,"97,06",28,28
270900,TANQUE D´ARCA,AL,12/2022,1834,1738,"94,77",28,68,387,317,"81,91",317,317,1447,1421,"98,20",42,42
270910,TAQUARANA,AL,06/2022,5789,4969,"85,84",,820,1394,903,"64,78",903,903,4395,4066,"92,51",142,142
270910,TAQUARANA,AL,12/2022,5949,5146,"86,50",1,802,1398,888,"63,52",888,888,4551,4258,"93,56",158,158
270915,TEOTÔNIO VILELA,AL,06/2022,12001,9453,"78,77",536,2012,2999,1138,"37,95",1138,1138,9002,8315,"92,37",298,298
270915,TEOTÔNIO VILELA,AL,12/2022,12078,10093,"83,57",1327,658,2921,1477,"50,56",1476,1477,9157,8616,"94,09",312,312
270920,TRAIPU,AL,06/2022,8488,7446,"87,72",,1042,2136,1548,"72,47",1548,1548,6352,5898,"92,85",263,263
270920,TRAIPU,AL,12/2022,8602,7715,"89,69",,887,2120,1582,"74,62",1582,1581,6482,6133,"94,62",293,293
270930,UNIÃO DOS PALMARES,AL,12/2022,20630,17594,"85,28",30,3006,5331,3395,"63,68",3395,3395,15299,14199,"92,81",518,518
270930,UNIÃO DOS PALMARES,AL,06/2022,20443,17764,"86,90",3,2676,5419,3766,"69,50",3765,3766,15024,13998,"93,17",464,464
270940,VIÇOSA,AL,12/2022,8502,6594,"77,56",512,1396,2181,1037,"47,55",1037,1037,6321,5557,"87,91",259,259
270940,VIÇOSA,AL,06/2022,8490,6332,"74,58",527,1631,2207,944,"42,77",944,944,6283,5388,"85,76",257,257
130002,ALVARÃES,AM,06/2022,6916,6215,"89,86",,701,2106,1637,"77,73",1637,1637,4810,4578,"95,18",167,167
130002,ALVARÃES,AM,12/2022,6810,5911,"86,80",1,898,2002,1453,"72,58",1453,1453,4808,4458,"92,72",197,197
130006,AMATURÁ,AM,06/2022,4601,4184,"90,94",54,363,1688,1428,"84,60",1426,1428,2913,2756,"94,61",130,130
130006,AMATURÁ,AM,12/2022,4709,4707,"99,96",2,,1671,1671,"100,00",1671,1367,3038,3036,"99,93",122,122
130008,ANAMÃ,AM,12/2022,4342,2688,"61,91",,1654,1398,204,"14,59",201,204,2944,2484,"84,38",125,125
130008,ANAMÃ,AM,06/2022,4338,2485,"57,28",,1853,1485,203,"13,67",203,203,2853,2282,"79,99",106,106
130010,ANORI,AM,06/2022,6044,5199,"86,02",102,743,1721,1188,"69,03",1188,1188,4323,4011,"92,78",145,145
130010,ANORI,AM,12/2022,6057,5443,"89,86",174,440,1624,1276,"78,57",1263,1276,4433,4167,"94,00",143,143
130014,APUÍ,AM,12/2022,4568,4000,"87,57",9,559,1256,890,"70,86",890,890,3312,3110,"93,90",101,101
130014,APUÍ,AM,06/2022,4182,2993,"71,57",32,1157,1213,432,"35,61",432,432,2969,2561,"86,26",98,98
130020,ATALAIA DO NORTE,AM,12/2022,5670,4048,"71,39",1,1621,1911,1060,"55,47",1053,1060,3759,2988,"79,49",136,136
130020,ATALAIA DO NORTE,AM,06/2022,5723,3684,"64,37",,2039,2003,805,"40,19",805,804,3720,2879,"77,39",128,128
130030,AUTAZES,AM,06/2022,18203,13140,"72,19",105,4958,5622,2621,"46,62",2606,2493,12581,10519,"83,61",419,419
130030,AUTAZES,AM,12/2022,19587,16056,"81,97",37,3494,5569,3525,"63,30",3509,3274,14018,12531,"89,39",443,442
130040,BARCELOS,AM,06/2022,5883,4248,"72,21",,1635,1882,982,"52,18",957,981,4001,3266,"81,63",162,162
130040,BARCELOS,AM,12/2022,6385,6188,"96,91",,197,1810,1703,"94,09",1692,1703,4575,4485,"98,03",136,136
130050,BARREIRINHA,AM,06/2022,14046,10257,"73,02",96,3693,4237,1676,"39,56",1676,1661,9809,8581,"87,48",340,340
130050,BARREIRINHA,AM,12/2022,14502,13086,"90,24",83,1333,4095,3302,"80,63",3302,3143,10407,9784,"94,01",242,242
130060,BENJAMIN CONSTANT,AM,06/2022,15046,9196,"61,12",26,5824,5355,2044,"38,17",2044,2044,9691,7152,"73,80",348,348
130060,BENJAMIN CONSTANT,AM,12/2022,15795,13091,"82,88",54,2650,5058,3686,"72,87",3686,3686,10737,9405,"87,59",349,349
130063,BERURI,AM,06/2022,10650,6658,"62,52",12,3980,3694,1312,"35,52",1307,1312,6956,5346,"76,85",312,312
130063,BERURI,AM,12/2022,11257,9130,"81,11",4,2123,3576,2342,"65,49",2255,2342,7681,6788,"88,37",331,330
130068,BOA VISTA DO RAMOS,AM,12/2022,6383,5864,"91,87",229,290,1772,1483,"83,69",1475,1483,4611,4381,"95,01",154,154
130068,BOA VISTA DO RAMOS,AM,06/2022,6354,5671,"89,25",621,62,1887,1480,"78,43",1470,1480,4467,4191,"93,82",158,157
130070,BOCA DO ACRE,AM,06/2022,10166,7481,"73,59",201,2484,2712,1573,"58,00",1573,1573,7454,5908,"79,26",312,312
130070,BOCA DO ACRE,AM,12/2022,10584,8201,"77,48",3,2380,2699,1588,"58,84",1584,1588,7885,6613,"83,87",299,299
130080,BORBA,AM,12/2022,13512,12294,"90,99",509,709,4114,3549,"86,27",3549,3549,9398,8745,"93,05",271,271
130080,BORBA,AM,06/2022,13516,10479,"77,53",120,2917,4214,2604,"61,79",2604,2604,9302,7875,"84,66",267,267
130083,CAAPIRANGA,AM,12/2022,4362,3559,"81,59",2,801,1281,849,"66,28",785,848,3081,2710,"87,96",125,125
130083,CAAPIRANGA,AM,06/2022,4413,3686,"83,53",1,726,1347,976,"72,46",879,974,3066,2710,"88,39",125,125
130090,CANUTAMA,AM,12/2022,5776,5427,"93,96",4,345,1567,1396,"89,09",1396,1396,4209,4031,"95,77",157,157
130090,CANUTAMA,AM,06/2022,5810,5420,"93,29",3,387,1657,1461,"88,17",1461,1461,4153,3959,"95,33",120,120
130100,CARAUARI,AM,06/2022,12164,7643,"62,83",1,4520,3596,965,"26,84",965,965,8568,6678,"77,94",368,368
130100,CARAUARI,AM,12/2022,12605,10057,"79,79",,2548,3362,1888,"56,16",1888,1888,9243,8169,"88,38",340,340
130110,CAREIRO,AM,06/2022,11455,9437,"82,38",48,1970,3124,2055,"65,78",2043,2055,8331,7382,"88,61",258,258
130110,CAREIRO,AM,12/2022,11490,9653,"84,01",48,1789,3101,2061,"66,46",2056,2060,8389,7592,"90,50",267,267
130115,CAREIRO DA VÁRZEA,AM,06/2022,8312,7375,"88,73",480,457,2125,1678,"78,96",1667,1669,6187,5697,"92,08",146,146
130115,CAREIRO DA VÁRZEA,AM,12/2022,8341,7347,"88,08",483,511,2109,1619,"76,77",1608,1619,6232,5728,"91,91",171,171
130120,COARI,AM,12/2022,24455,19289,"78,88",12,5154,6327,3470,"54,84",3469,3470,18128,15819,"87,26",682,682
130120,COARI,AM,06/2022,23225,14836,"63,88",1,8388,6427,1191,"18,53",1191,1191,16798,13645,"81,23",703,703
130130,CODAJÁS,AM,12/2022,8751,7217,"82,47",53,1481,2590,1619,"62,51",1617,1618,6161,5598,"90,86",223,223
130130,CODAJÁS,AM,06/2022,8756,6863,"78,38",6,1887,2703,1359,"50,28",1358,1358,6053,5504,"90,93",280,280
130140,EIRUNEPÉ,AM,06/2022,13812,13069,"94,62",6,737,3583,3203,"89,39",3203,3202,10229,9866,"96,45",382,382
130140,EIRUNEPÉ,AM,12/2022,13560,12062,"88,95",13,1485,3448,2650,"76,86",2650,2650,10112,9412,"93,08",396,396
130150,ENVIRA,AM,06/2022,7296,6777,"92,89",29,490,2186,1894,"86,64",1891,1893,5110,4883,"95,56",166,166
130150,ENVIRA,AM,12/2022,7149,6655,"93,09",31,463,2056,1794,"87,26",1794,1794,5093,4861,"95,44",158,158
130160,FONTE BOA,AM,12/2022,10882,9259,"85,09",,1623,3309,1991,"60,17",1991,1991,7573,7268,"95,97",304,304
130160,FONTE BOA,AM,06/2022,10276,6685,"65,05",,3591,3340,482,"14,43",482,482,6936,6203,"89,43",336,336
130165,GUAJARÁ,AM,12/2022,6676,5744,"86,04",3,929,1846,1336,"72,37",1334,1336,4830,4408,"91,26",133,133
130165,GUAJARÁ,AM,06/2022,6535,5536,"84,71",3,996,1888,1351,"71,56",1351,1351,4647,4185,"90,06",132,132
130170,HUMAITÁ,AM,12/2022,18490,16937,"91,60",111,1442,4705,3826,"81,32",3825,3826,13785,13111,"95,11",488,488
130170,HUMAITÁ,AM,06/2022,17379,13618,"78,36",127,3634,4718,2193,"46,48",2192,2193,12661,11425,"90,24",425,425
130180,IPIXUNA,AM,06/2022,7310,4612,"63,09",,2698,2376,1122,"47,22",1122,1122,4934,3490,"70,73",74,74
130180,IPIXUNA,AM,12/2022,7870,6977,"88,65",1,892,2301,1821,"79,14",1821,1821,5569,5156,"92,58",176,176
130185,IRANDUBA,AM,06/2022,24091,18901,"78,46",120,5070,6453,3538,"54,83",3532,3538,17638,15363,"87,10",546,546
130185,IRANDUBA,AM,12/2022,24796,20959,"84,53",1,3836,6115,4100,"67,05",4100,4100,18681,16859,"90,25",620,620
130190,ITACOATIARA,AM,12/2022,31653,28364,"89,61",747,2542,7994,5873,"73,47",5854,5872,23659,22491,"95,06",1006,1006
130190,ITACOATIARA,AM,06/2022,30246,25812,"85,34",868,3566,8191,5229,"63,84",5212,5229,22055,20583,"93,33",866,866
130195,ITAMARATI,AM,12/2022,4306,3531,"82,00",1,774,1518,1064,"70,09",1064,1064,2788,2467,"88,49",151,151
130195,ITAMARATI,AM,06/2022,4143,2308,"55,71",,1835,1562,499,"31,95",499,499,2581,1809,"70,09",116,116
130200,ITAPIRANGA,AM,06/2022,4019,3541,"88,11",173,305,1180,878,"74,41",877,878,2839,2663,"93,80",126,126
130200,ITAPIRANGA,AM,12/2022,4120,3706,"89,95",211,203,1117,860,"76,99",860,860,3003,2846,"94,77",132,132
130210,JAPURÁ,AM,06/2022,2417,1790,"74,06",11,616,708,384,"54,24",384,384,1709,1406,"82,27",75,75
130210,JAPURÁ,AM,12/2022,2744,2339,"85,24",6,399,767,554,"72,23",554,554,1977,1785,"90,29",101,101
130220,JURUÁ,AM,12/2022,4246,3700,"87,14",2,544,1103,785,"71,17",785,784,3143,2915,"92,75",131,131
130220,JURUÁ,AM,06/2022,4046,3047,"75,31",12,987,1178,613,"52,04",613,613,2868,2434,"84,87",127,127
130230,JUTAÍ,AM,06/2022,9659,7158,"74,11",12,2489,3298,1877,"56,91",1875,1877,6361,5281,"83,02",258,258
130230,JUTAÍ,AM,12/2022,9812,7778,"79,27",2,2032,3232,2139,"66,18",2139,2139,6580,5639,"85,70",237,237
130240,LÁBREA,AM,12/2022,19292,19288,"99,98",,4,5062,5061,"99,98",5061,5061,14230,14227,"99,98",576,576
130240,LÁBREA,AM,06/2022,18516,16345,"88,28",,2171,5269,3931,"74,61",3929,3931,13247,12414,"93,71",512,512
130250,MANACAPURU,AM,06/2022,40414,32653,"80,80",1088,6673,10965,6567,"59,89",6450,6480,29449,26086,"88,58",1017,1016
130250,MANACAPURU,AM,12/2022,42469,38393,"90,40",3277,799,10552,7538,"71,44",7112,7496,31917,30855,"96,67",976,974
130255,MANAQUIRI,AM,06/2022,7474,6757,"90,41",489,228,2179,1754,"80,50",1746,1745,5295,5003,"94,49",248,248
130255,MANAQUIRI,AM,12/2022,7497,6831,"91,12",346,320,2119,1731,"81,69",1731,1731,5378,5100,"94,83",231,231
130260,MANAUS,AM,12/2022,330990,215690,"65,17",1274,114026,80008,29886,"37,35",29858,29874,250982,185804,"74,03",6585,6584
130260,MANAUS,AM,06/2022,288708,178904,"61,97",852,108952,74726,26270,"35,16",26265,26261,213982,152634,"71,33",5035,5034
130270,MANICORÉ,AM,06/2022,15918,12198,"76,63",1,3719,4859,2637,"54,27",2634,2637,11059,9561,"86,45",444,444
130270,MANICORÉ,AM,12/2022,16534,14094,"85,24",28,2412,4940,3521,"71,28",3515,3521,11594,10573,"91,19",399,399
130280,MARAÃ,AM,12/2022,7712,7295,"94,59",45,372,2226,1988,"89,31",1988,1988,5486,5307,"96,74",177,177
130280,MARAÃ,AM,06/2022,7565,6948,"91,84",108,509,2314,2023,"87,42",2021,2023,5251,4925,"93,79",190,190
130290,MAUÉS,AM,12/2022,23886,19352,"81,02",81,4453,6996,4490,"64,18",4488,4490,16890,14862,"87,99",554,554
130290,MAUÉS,AM,06/2022,24042,19443,"80,87",316,4283,7513,4841,"64,43",4840,4841,16529,14602,"88,34",502,502
130300,NHAMUNDÁ,AM,12/2022,8662,7800,"90,05",760,102,2410,1922,"79,75",1900,1922,6252,5878,"94,02",248,247
130300,NHAMUNDÁ,AM,06/2022,8412,6565,"78,04",4,1843,2504,1400,"55,91",1399,1400,5908,5165,"87,42",244,243
130310,NOVA OLINDA DO NORTE,AM,12/2022,12004,10233,"85,25",88,1683,3665,2580,"70,40",2580,2580,8339,7653,"91,77",399,399
130310,NOVA OLINDA DO NORTE,AM,06/2022,11666,9893,"84,80",39,1734,3713,2599,"70,00",2599,2599,7953,7294,"91,71",337,337
130320,NOVO AIRÃO,AM,12/2022,5442,4166,"76,55",57,1219,1597,816,"51,10",816,816,3845,3350,"87,13",171,171
130320,NOVO AIRÃO,AM,06/2022,5222,2825,"54,10",4,2393,1687,139,"8,24",139,139,3535,2686,"75,98",123,123
130330,NOVO ARIPUANÃ,AM,12/2022,7457,7402,"99,26",,55,2064,2031,"98,40",2031,2031,5393,5371,"99,59",250,250
130330,NOVO ARIPUANÃ,AM,06/2022,7660,7126,"93,03",,534,2210,1931,"87,38",1931,1931,5450,5195,"95,32",253,253
130340,PARINTINS,AM,06/2022,36850,19788,"53,70",3,17059,11138,1261,"11,32",1261,1258,25712,18527,"72,06",1036,1035
130340,PARINTINS,AM,12/2022,37184,24253,"65,22",14,12917,10767,3776,"35,07",3776,3774,26417,20477,"77,51",814,814
130350,PAUINI,AM,06/2022,7257,5686,"78,35",4,1567,2362,1555,"65,83",1555,1555,4895,4131,"84,39",187,187
130350,PAUINI,AM,12/2022,7040,4966,"70,54",5,2069,2275,1177,"51,74",1176,1177,4765,3789,"79,52",172,172
130353,PRESIDENTE FIGUEIREDO,AM,12/2022,9676,7274,"75,18",778,1624,2557,1146,"44,82",1146,1140,7119,6128,"86,08",259,259
130353,PRESIDENTE FIGUEIREDO,AM,06/2022,9240,6643,"71,89",489,2108,2566,1041,"40,57",1041,1040,6674,5602,"83,94",286,285
130356,RIO PRETO DA EVA,AM,12/2022,7965,6181,"77,60",539,1245,2162,1038,"48,01",1033,1037,5803,5143,"88,63",203,203
130356,RIO PRETO DA EVA,AM,06/2022,7503,5580,"74,37",147,1776,2099,879,"41,88",872,873,5404,4701,"86,99",200,200
130360,SANTA ISABEL DO RIO NEGRO,AM,12/2022,5336,4262,"79,87",1,1073,1656,1115,"67,33",1115,1115,3680,3147,"85,52",108,108
130360,SANTA ISABEL DO RIO NEGRO,AM,06/2022,5273,4024,"76,31",,1249,1683,1082,"64,29",1082,1082,3590,2942,"81,95",118,118
130370,SANTO ANTÔNIO DO IÇÁ,AM,12/2022,11512,10310,"89,56",223,979,3724,3015,"80,96",3015,2918,7788,7295,"93,67",302,302
130370,SANTO ANTÔNIO DO IÇÁ,AM,06/2022,11084,7758,"69,99",44,3282,3891,2053,"52,76",2053,2051,7193,5705,"79,31",276,276
130380,SÃO GABRIEL DA CACHOEIRA,AM,12/2022,16289,10772,"66,13",46,5471,5387,2921,"54,22",2921,2921,10902,7851,"72,01",336,336
130380,SÃO GABRIEL DA CACHOEIRA,AM,06/2022,14940,9084,"60,80",1,5855,4749,2275,"47,90",2275,2274,10191,6809,"66,81",293,293
130390,SÃO PAULO DE OLIVENÇA,AM,06/2022,12738,7638,"59,96",2,5098,5090,2183,"42,89",2183,2183,7648,5455,"71,33",246,246
130390,SÃO PAULO DE OLIVENÇA,AM,12/2022,14201,10133,"71,35",,4068,5182,2991,"57,72",2991,2991,9019,7142,"79,19",258,258
130395,SÃO SEBASTIÃO DO UATUMÃ,AM,06/2022,4006,4006,"100,00",,,1279,1279,"100,00",1261,993,2727,2727,"100,00",147,147
130395,SÃO SEBASTIÃO DO UATUMÃ,AM,12/2022,4071,4068,"99,93",1,2,1253,1252,"99,92",1193,1132,2818,2816,"99,93",128,128
130400,SILVES,AM,06/2022,4690,4573,"97,51",19,98,1418,1331,"93,86",1330,1331,3272,3242,"99,08",162,162
130400,SILVES,AM,12/2022,4623,4432,"95,87",2,189,1347,1214,"90,13",1212,1214,3276,3218,"98,23",150,150
130406,TABATINGA,AM,12/2022,20220,19191,"94,91",308,721,5427,4859,"89,53",4858,4852,14793,14332,"96,88",412,412
130406,TABATINGA,AM,06/2022,18512,16651,"89,95",93,1768,5227,4165,"79,68",4165,4153,13285,12486,"93,99",428,427
130410,TAPAUÁ,AM,06/2022,6482,4171,"64,35",,2311,1967,640,"32,54",640,640,4515,3531,"78,21",182,179
130410,TAPAUÁ,AM,12/2022,7109,6080,"85,53",,1029,2061,1487,"72,15",1487,1487,5048,4593,"90,99",215,215
130420,TEFÉ,AM,06/2022,26662,25219,"94,59",,1443,8183,7152,"87,40",7152,7152,18479,18067,"97,77",814,814
130420,TEFÉ,AM,12/2022,27839,27688,"99,46",12,139,8114,8025,"98,90",8019,8025,19725,19663,"99,69",838,837
130423,TONANTINS,AM,06/2022,7712,7482,"97,02",,230,2550,2402,"94,20",2402,2402,5162,5080,"98,41",246,246
130423,TONANTINS,AM,12/2022,7797,7641,"98,00",,156,2496,2399,"96,11",2399,2399,5301,5242,"98,89",262,262
130426,UARINI,AM,12/2022,6453,6453,"100,00",,,1775,1775,"100,00",1421,1422,4678,4678,"100,00",249,249
130426,UARINI,AM,06/2022,6406,6406,"100,00",,,1929,1929,"100,00",1749,1411,4477,4477,"100,00",231,231
130430,URUCARÁ,AM,12/2022,6864,6852,"99,83",,12,1837,1831,"99,67",1829,1831,5027,5021,"99,88",195,195
130430,URUCARÁ,AM,06/2022,6651,6527,"98,14",3,121,1872,1788,"95,51",1786,1787,4779,4739,"99,16",189,189
130440,URUCURITUBA,AM,12/2022,8670,8667,"99,97",3,,2391,2389,"99,92",2385,2386,6279,6278,"99,98",204,204
130440,URUCURITUBA,AM,06/2022,8057,7932,"98,45",4,121,2515,2434,"96,78",2406,2434,5542,5498,"99,21",226,226
160005,SERRA DO NAVIO,AP,06/2022,1635,1176,"71,93",24,435,447,128,"28,64",128,128,1188,1048,"88,22",51,51
160005,SERRA DO NAVIO,AP,12/2022,1728,1435,"83,04",1,292,437,245,"56,06",244,245,1291,1190,"92,18",66,66
160010,AMAPÁ,AP,06/2022,3470,2186,"63,00",39,1245,958,135,"14,09",135,135,2512,2051,"81,65",116,116
160010,AMAPÁ,AP,12/2022,3531,2992,"84,74",487,52,901,603,"66,93",603,603,2630,2389,"90,84",112,112
160015,PEDRA BRANCA DO AMAPARI,AP,12/2022,4951,4100,"82,81",3,848,1346,907,"67,38",907,907,3605,3193,"88,57",107,107
160015,PEDRA BRANCA DO AMAPARI,AP,06/2022,4376,2500,"57,13",,1876,1384,372,"26,88",372,372,2992,2128,"71,12",145,145
160020,CALÇOENE,AP,06/2022,3327,2218,"66,67",,1109,1080,408,"37,78",408,408,2247,1810,"80,55",115,115
160020,CALÇOENE,AP,12/2022,3664,3232,"88,21",,432,1048,787,"75,10",787,787,2616,2445,"93,46",118,118
160021,CUTIAS,AP,12/2022,2375,1957,"82,40",,418,761,514,"67,54",514,508,1614,1443,"89,41",66,66
160021,CUTIAS,AP,06/2022,2347,1935,"82,45",,412,725,489,"67,45",487,454,1622,1446,"89,15",74,74
160023,FERREIRA GOMES,AP,06/2022,2153,1603,"74,45",1,549,664,367,"55,27",365,367,1489,1236,"83,01",75,75
160023,FERREIRA GOMES,AP,12/2022,2180,1670,"76,61",,510,640,372,"58,13",371,372,1540,1298,"84,29",81,79
160025,ITAUBAL,AP,06/2022,2775,1669,"60,14",4,1102,841,138,"16,41",137,138,1934,1531,"79,16",85,85
160025,ITAUBAL,AP,12/2022,2850,1850,"64,91",1,999,797,151,"18,95",146,151,2053,1699,"82,76",72,72
160027,LARANJAL DO JARI,AP,06/2022,13122,10274,"78,30",,2848,3476,1913,"55,03",1913,1913,9646,8361,"86,68",362,362
160027,LARANJAL DO JARI,AP,12/2022,13457,10363,"77,01",2,3092,3427,1743,"50,86",1743,1743,10030,8620,"85,94",409,409
160030,MACAPÁ,AP,12/2022,87948,51344,"58,38",140,36464,25237,9163,"36,31",9145,9146,62711,42181,"67,26",1683,1682
160030,MACAPÁ,AP,06/2022,82820,39991,"48,29",172,42657,25618,6169,"24,08",6168,6152,57202,33822,"59,13",1666,1666
160040,MAZAGÃO,AP,12/2022,10631,10276,"96,66",,355,2817,2754,"97,76",2754,2754,7814,7522,"96,26",214,214
160040,MAZAGÃO,AP,06/2022,10431,9927,"95,17",,504,2934,2829,"96,42",2829,2829,7497,7098,"94,68",198,198
160050,OIAPOQUE,AP,12/2022,6167,3670,"59,51",5,2492,1834,610,"33,26",610,610,4333,3060,"70,62",188,188
160050,OIAPOQUE,AP,06/2022,5583,2590,"46,39",,2993,1784,119,"6,67",119,119,3799,2471,"65,04",126,126
160053,PORTO GRANDE,AP,12/2022,6183,3668,"59,32",3,2512,1742,287,"16,48",287,287,4441,3381,"76,13",190,190
160053,PORTO GRANDE,AP,06/2022,5779,2866,"49,59",,2913,1773,116,"6,54",116,115,4006,2750,"68,65",190,190
160055,PRACUÚBA,AP,06/2022,1464,1145,"78,21",17,302,399,202,"50,63",202,202,1065,943,"88,54",46,46
160055,PRACUÚBA,AP,12/2022,1667,1460,"87,58",35,172,393,259,"65,90",259,259,1274,1201,"94,27",46,46
160060,SANTANA,AP,12/2022,33962,22784,"67,09",12,11166,8955,3921,"43,79",3915,3920,25007,18863,"75,43",568,567
160060,SANTANA,AP,06/2022,32776,20023,"61,09",8,12745,9519,3488,"36,64",3487,3483,23257,16535,"71,10",598,597
160070,TARTARUGALZINHO,AP,12/2022,5564,4621,"83,05",,943,1730,1109,"64,10",1109,1109,3834,3512,"91,60",156,156
160070,TARTARUGALZINHO,AP,06/2022,5290,4074,"77,01",,1216,1669,861,"51,59",857,861,3621,3213,"88,73",161,161
160080,VITÓRIA DO JARI,AP,06/2022,5603,4419,"78,87",22,1162,1545,855,"55,34",855,853,4058,3564,"87,83",163,163
160080,VITÓRIA DO JARI,AP,12/2022,5523,4389,"79,47",219,915,1486,843,"56,73",822,842,4037,3546,"87,84",190,189
290010,ABAÍRA,BA,12/2022,2264,2053,"90,68",,211,394,284,"72,08",284,284,1870,1769,"94,60",27,27
290010,ABAÍRA,BA,06/2022,2194,1879,"85,64",,315,405,239,"59,01",239,239,1789,1640,"91,67",31,31
290020,ABARÉ,BA,06/2022,7526,6917,"91,91",89,520,1795,1460,"81,34",1460,1453,5731,5457,"95,22",146,146
290020,ABARÉ,BA,12/2022,7392,6798,"91,96",48,546,1712,1360,"79,44",1360,1359,5680,5438,"95,74",161,161
290030,ACAJUTIBA,BA,12/2022,5380,4840,"89,96",,540,1182,819,"69,29",819,819,4198,4021,"95,78",129,129
290030,ACAJUTIBA,BA,06/2022,5468,4942,"90,38",,526,1265,904,"71,46",904,904,4203,4038,"96,07",133,133
290035,ADUSTINA,BA,12/2022,4987,4489,"90,01",42,456,1009,740,"73,34",740,740,3978,3749,"94,24",106,106
290035,ADUSTINA,BA,06/2022,4901,4109,"83,84",29,763,1030,642,"62,33",642,642,3871,3467,"89,56",116,116
290040,ÁGUA FRIA,BA,06/2022,5168,4537,"87,79",108,523,1135,796,"70,13",796,794,4033,3741,"92,76",126,126
290040,ÁGUA FRIA,BA,12/2022,5383,4790,"88,98",92,501,1107,782,"70,64",782,782,4276,4008,"93,73",148,148
290050,ÉRICO CARDOSO,BA,06/2022,2667,2441,"91,53",19,207,500,323,"64,60",323,323,2167,2118,"97,74",46,46
290050,ÉRICO CARDOSO,BA,12/2022,2635,2420,"91,84",27,188,522,359,"68,77",359,359,2113,2061,"97,54",47,47
290060,AIQUARA,BA,12/2022,1322,1083,"81,92",,239,307,173,"56,35",173,173,1015,910,"89,66",24,24
290060,AIQUARA,BA,06/2022,1303,1128,"86,57",,175,302,206,"68,21",206,206,1001,922,"92,11",19,19
290070,ALAGOINHAS,BA,06/2022,37504,27538,"73,43",14,9952,8400,3611,"42,99",3611,3610,29104,23927,"82,21",757,757
290070,ALAGOINHAS,BA,12/2022,41088,36900,"89,81",23,4165,7997,6287,"78,62",6287,6287,33091,30613,"92,51",815,815
290080,ALCOBAÇA,BA,12/2022,7290,4826,"66,20",27,2437,1808,308,"17,04",308,302,5482,4518,"82,42",169,169
290080,ALCOBAÇA,BA,06/2022,6928,4408,"63,63",,2520,1774,237,"13,36",237,226,5154,4171,"80,93",169,169
290090,ALMADINA,BA,12/2022,1898,1684,"88,72",2,212,393,272,"69,21",272,272,1505,1412,"93,82",23,23
290090,ALMADINA,BA,06/2022,1875,1523,"81,23",5,347,419,227,"54,18",227,227,1456,1296,"89,01",28,28
290100,AMARGOSA,BA,12/2022,9670,8416,"87,03",,1254,2018,1318,"65,31",1318,1318,7652,7098,"92,76",199,199
290100,AMARGOSA,BA,06/2022,9655,7953,"82,37",8,1694,2046,1095,"53,52",1095,1095,7609,6858,"90,13",150,150
290110,AMÉLIA RODRIGUES,BA,12/2022,6356,4990,"78,51",10,1356,1277,593,"46,44",593,593,5079,4397,"86,57",119,119
290110,AMÉLIA RODRIGUES,BA,06/2022,6080,4091,"67,29",,1989,1334,384,"28,79",384,384,4746,3707,"78,11",100,100
290115,AMÉRICA DOURADA,BA,06/2022,5150,3695,"71,75",,1455,1299,398,"30,64",398,398,3851,3297,"85,61",125,125
290115,AMÉRICA DOURADA,BA,12/2022,5339,4344,"81,36",2,993,1268,627,"49,45",627,627,4071,3717,"91,30",91,91
290120,ANAGÉ,BA,06/2022,7503,6537,"87,13",22,944,1509,999,"66,20",999,999,5994,5538,"92,39",100,100
290120,ANAGÉ,BA,12/2022,7377,6648,"90,12",46,683,1404,1015,"72,29",1015,1015,5973,5633,"94,31",117,117
290130,ANDARAÍ,BA,12/2022,4703,4164,"88,54",155,384,1029,709,"68,90",709,708,3674,3455,"94,04",102,102
290130,ANDARAÍ,BA,06/2022,4578,3957,"86,44",52,569,1072,743,"69,31",743,743,3506,3214,"91,67",92,92
290135,ANDORINHA,BA,12/2022,4042,2770,"68,53",1,1271,887,124,"13,98",124,124,3155,2646,"83,87",82,82
290135,ANDORINHA,BA,06/2022,4271,3615,"84,64",1,655,944,586,"62,08",20,20,3327,3029,"91,04",41,41
290140,ANGICAL,BA,12/2022,5136,4463,"86,90",,673,1197,793,"66,25",793,793,3939,3670,"93,17",125,125
290140,ANGICAL,BA,06/2022,5195,4401,"84,72",3,791,1258,788,"62,64",788,788,3937,3613,"91,77",168,168
290150,ANGUERA,BA,12/2022,3353,3056,"91,14",,297,692,529,"76,45",529,529,2661,2527,"94,96",49,49
290150,ANGUERA,BA,06/2022,3303,3039,"92,01",,264,722,574,"79,50",574,574,2581,2465,"95,51",50,50
290160,ANTAS,BA,12/2022,3698,3170,"85,72",21,507,788,525,"66,62",525,525,2910,2645,"90,89",51,51
290160,ANTAS,BA,06/2022,3661,3129,"85,47",2,530,797,517,"64,87",517,517,2864,2612,"91,20",64,64
290170,ANTÔNIO CARDOSO,BA,06/2022,4096,2103,"51,34",3,1990,1092,47,"4,30",47,47,3004,2056,"68,44",85,85
290170,ANTÔNIO CARDOSO,BA,12/2022,4589,4076,"88,82",4,509,1067,775,"72,63",775,775,3522,3301,"93,73",108,108
290180,ANTÔNIO GONÇALVES,BA,06/2022,3721,3234,"86,91",145,342,933,663,"71,06",663,653,2788,2571,"92,22",66,66
290180,ANTÔNIO GONÇALVES,BA,12/2022,3776,3508,"92,90",69,199,895,748,"83,58",746,644,2881,2760,"95,80",67,67
290190,APORÁ,BA,12/2022,5711,4748,"83,14",9,954,1236,693,"56,07",693,692,4475,4055,"90,61",128,128
290190,APORÁ,BA,06/2022,5696,4729,"83,02",59,908,1282,781,"60,92",781,779,4414,3948,"89,44",117,117
290195,APUAREMA,BA,06/2022,2576,2031,"78,84",1,544,657,346,"52,66",345,345,1919,1685,"87,81",37,37
290195,APUAREMA,BA,12/2022,2699,2207,"81,77",,492,646,345,"53,41",345,345,2053,1862,"90,70",54,54
290200,ARACATU,BA,12/2022,4460,4268,"95,70",45,147,903,769,"85,16",769,765,3557,3499,"98,37",138,138
290200,ARACATU,BA,06/2022,4480,4167,"93,01",4,309,934,765,"81,91",765,765,3546,3402,"95,94",120,120
290205,ARAÇAS,BA,06/2022,4424,3747,"84,70",,677,980,636,"64,90",636,636,3444,3111,"90,33",81,81
290205,ARAÇAS,BA,12/2022,4524,4111,"90,87",1,412,944,726,"76,91",726,726,3580,3385,"94,55",79,79
290210,ARACI,BA,12/2022,16811,12493,"74,31",1,4317,3864,1283,"33,20",1283,1283,12947,11210,"86,58",303,303
290210,ARACI,BA,06/2022,16080,10798,"67,15",,5282,3832,867,"22,63",867,867,12248,9931,"81,08",374,374
290220,ARAMARI,BA,06/2022,3543,3073,"86,73",,470,755,523,"69,27",523,522,2788,2550,"91,46",56,56
290220,ARAMARI,BA,12/2022,3529,2774,"78,61",,755,733,306,"41,75",306,306,2796,2468,"88,27",59,59
290225,ARATACA,BA,06/2022,2878,1825,"63,41",,1053,680,22,"3,24",22,8,2198,1803,"82,03",57,57
290225,ARATACA,BA,12/2022,2914,2267,"77,80",1,646,615,225,"36,59",225,225,2299,2042,"88,82",42,42
290230,ARATUÍPE,BA,06/2022,3627,3155,"86,99",,472,842,583,"69,24",583,583,2785,2572,"92,35",64,64
290230,ARATUÍPE,BA,12/2022,3648,3256,"89,25",,392,790,555,"70,25",555,553,2858,2701,"94,51",58,58
290240,AURELINO LEAL,BA,06/2022,4810,4130,"85,86",159,521,1118,751,"67,17",751,751,3692,3379,"91,52",84,84
290240,AURELINO LEAL,BA,12/2022,4737,3959,"83,58",162,616,1028,591,"57,49",591,588,3709,3368,"90,81",101,101
290250,BAIANÓPOLIS,BA,12/2022,5083,4157,"81,78",57,869,1236,730,"59,06",730,730,3847,3427,"89,08",160,160
290250,BAIANÓPOLIS,BA,06/2022,5193,4356,"83,88",,837,1283,835,"65,08",835,835,3910,3521,"90,05",128,128
290260,BAIXA GRANDE,BA,12/2022,5540,4617,"83,34",1,922,1202,834,"69,38",834,834,4338,3783,"87,21",104,104
290260,BAIXA GRANDE,BA,06/2022,5574,4538,"81,41",,1036,1229,803,"65,34",803,803,4345,3735,"85,96",106,106
290265,BANZAÊ,BA,06/2022,3865,2960,"76,58",,905,1008,433,"42,96",433,433,2857,2527,"88,45",72,72
290265,BANZAÊ,BA,12/2022,3925,3452,"87,95",,473,958,598,"62,42",598,598,2967,2854,"96,19",93,93
290270,BARRA,BA,12/2022,17799,15448,"86,79",86,2265,4684,3559,"75,98",3559,3559,13115,11889,"90,65",552,552
290270,BARRA,BA,06/2022,17378,15084,"86,80",138,2156,4676,3655,"78,17",3655,3655,12702,11429,"89,98",439,439
290280,BARRA DA ESTIVA,BA,12/2022,7727,7195,"93,12",45,487,1651,1325,"80,25",1325,1325,6076,5870,"96,61",140,140
290280,BARRA DA ESTIVA,BA,06/2022,7610,6319,"83,04",32,1259,1713,852,"49,74",852,852,5897,5467,"92,71",137,137
290290,BARRA DO CHOÇA,BA,12/2022,12078,11100,"91,90",,978,2738,2061,"75,27",2061,2061,9340,9039,"96,78",212,212
290290,BARRA DO CHOÇA,BA,06/2022,11824,9155,"77,43",57,2612,2873,1097,"38,18",1097,1096,8951,8058,"90,02",205,205
290300,BARRA DO MENDES,BA,06/2022,4099,3254,"79,39",,845,905,274,"30,28",274,144,3194,2980,"93,30",104,104
290300,BARRA DO MENDES,BA,12/2022,4230,3939,"93,12",,291,954,743,"77,88",743,496,3276,3196,"97,56",97,97
290310,BARRA DO ROCHA,BA,12/2022,2023,1694,"83,74",,329,428,251,"58,64",251,251,1595,1443,"90,47",37,37
290310,BARRA DO ROCHA,BA,06/2022,1893,1579,"83,41",,314,405,235,"58,02",235,235,1488,1344,"90,32",31,31
290320,BARREIRAS,BA,12/2022,29554,22185,"75,07",222,7147,7141,3073,"43,03",3032,2980,22413,19112,"85,27",876,876
290320,BARREIRAS,BA,06/2022,27587,19694,"71,39",202,7691,7173,2739,"38,18",2658,2618,20414,16955,"83,06",811,811
290323,BARRO ALTO,BA,06/2022,4309,3034,"70,41",1,1274,1060,249,"23,49",249,249,3249,2785,"85,72",103,103
290323,BARRO ALTO,BA,12/2022,4229,2976,"70,37",,1253,1007,256,"25,42",256,256,3222,2720,"84,42",120,120
290327,BARROCAS,BA,12/2022,5262,4963,"94,32",29,270,1031,840,"81,47",840,840,4231,4123,"97,45",108,108
290327,BARROCAS,BA,06/2022,5176,4715,"91,09",25,436,1053,727,"69,04",727,727,4123,3988,"96,73",82,82
290330,BARRO PRETO,BA,06/2022,2373,1998,"84,20",,375,521,305,"58,54",305,305,1852,1693,"91,41",45,45
290330,BARRO PRETO,BA,12/2022,2317,2017,"87,05",,300,473,299,"63,21",299,298,1844,1718,"93,17",39,39
290340,BELMONTE,BA,06/2022,6247,4336,"69,41",,1911,1646,729,"44,29",729,729,4601,3607,"78,40",108,108
290340,BELMONTE,BA,12/2022,6743,5366,"79,58",,1377,1667,1023,"61,37",1023,1023,5076,4343,"85,56",147,147
290350,BELO CAMPO,BA,06/2022,5410,4860,"89,83",14,536,1183,782,"66,10",782,777,4227,4078,"96,48",101,101
290350,BELO CAMPO,BA,12/2022,5452,4430,"81,25",,1022,1131,302,"26,70",302,302,4321,4128,"95,53",95,95
290360,BIRITINGA,BA,06/2022,6001,4311,"71,84",88,1602,1332,409,"30,71",397,397,4669,3902,"83,57",137,137
290360,BIRITINGA,BA,12/2022,6335,5757,"90,88",68,510,1307,975,"74,60",965,975,5028,4782,"95,11",132,132
290370,BOA NOVA,BA,06/2022,4737,3161,"66,73",,1576,1094,68,"6,22",68,68,3643,3093,"84,90",89,89
290370,BOA NOVA,BA,12/2022,4638,3421,"73,76",,1217,1056,183,"17,33",183,183,3582,3238,"90,40",108,108
290380,BOA VISTA DO TUPIM,BA,12/2022,6457,5786,"89,61",,671,1429,1105,"77,33",1105,1105,5028,4681,"93,10",97,97
290380,BOA VISTA DO TUPIM,BA,06/2022,6752,6299,"93,29",5,448,1546,1350,"87,32",1350,1350,5206,4949,"95,06",109,109
290390,BOM JESUS DA LAPA,BA,12/2022,19906,17807,"89,46",926,1173,4768,3503,"73,47",3500,3503,15138,14304,"94,49",637,637
290390,BOM JESUS DA LAPA,BA,06/2022,19293,17128,"88,78",825,1340,4692,3392,"72,29",3392,3377,14601,13736,"94,08",576,576
290395,BOM JESUS DA SERRA,BA,06/2022,3082,2298,"74,56",,784,714,286,"40,06",286,286,2368,2012,"84,97",56,56
290395,BOM JESUS DA SERRA,BA,12/2022,3205,2702,"84,31",,503,703,445,"63,30",445,445,2502,2257,"90,21",77,77
290400,BONINAL,BA,06/2022,4368,3925,"89,86",7,436,1074,882,"82,12",882,882,3294,3043,"92,38",92,92
290400,BONINAL,BA,12/2022,4449,4079,"91,68",22,348,1079,872,"80,82",872,872,3370,3207,"95,16",107,107
290405,BONITO,BA,12/2022,5231,4346,"83,08",147,738,1357,803,"59,17",802,803,3874,3543,"91,46",120,120
290405,BONITO,BA,06/2022,5262,4298,"81,68",238,726,1436,889,"61,91",882,889,3826,3409,"89,10",129,129
290410,BOQUIRA,BA,06/2022,5292,2683,"50,70",,2609,1490,385,"25,84",385,385,3802,2298,"60,44",100,100
290410,BOQUIRA,BA,12/2022,5406,4354,"80,54",,1052,1456,1059,"72,73",1059,1059,3950,3295,"83,42",99,99
290420,BOTUPORÃ,BA,06/2022,3596,2840,"78,98",,756,775,276,"35,61",276,276,2821,2564,"90,89",76,76
290420,BOTUPORÃ,BA,12/2022,3650,3290,"90,14",,360,768,556,"72,40",556,556,2882,2734,"94,86",68,68
290430,BREJÕES,BA,12/2022,3887,3393,"87,29",161,333,824,518,"62,86",511,518,3063,2875,"93,86",64,63
290430,BREJÕES,BA,06/2022,3548,2454,"69,17",8,1086,821,179,"21,80",172,179,2727,2275,"83,43",91,91
290440,BREJOLÂNDIA,BA,06/2022,2582,2291,"88,73",8,283,558,363,"65,05",363,363,2024,1928,"95,26",55,55
290440,BREJOLÂNDIA,BA,12/2022,2606,2302,"88,33",13,291,572,385,"67,31",385,384,2034,1917,"94,25",53,53
290450,BROTAS DE MACAÚBAS,BA,12/2022,3654,3527,"96,52",118,9,800,731,"91,38",731,731,2854,2796,"97,97",113,113
290450,BROTAS DE MACAÚBAS,BA,06/2022,3601,3455,"95,95",135,11,834,763,"91,49",763,763,2767,2692,"97,29",104,104
290460,BRUMADO,BA,06/2022,11404,7695,"67,48",1,3708,2490,585,"23,49",585,585,8914,7110,"79,76",228,228
290460,BRUMADO,BA,12/2022,12191,10282,"84,34",158,1751,2481,1529,"61,63",1529,1529,9710,8753,"90,14",227,227
290470,BUERAREMA,BA,12/2022,4399,3766,"85,61",66,567,953,574,"60,23",574,522,3446,3192,"92,63",95,95
290470,BUERAREMA,BA,06/2022,4352,3645,"83,75",282,425,977,535,"54,76",535,535,3375,3110,"92,15",89,89
290475,BURITIRAMA,BA,06/2022,8171,6994,"85,60",4,1173,2186,1558,"71,27",1558,1558,5985,5436,"90,83",223,223
290475,BURITIRAMA,BA,12/2022,8158,7217,"88,47",21,920,2113,1590,"75,25",1590,1590,6045,5627,"93,09",220,220
290480,CAATIBA,BA,12/2022,1811,1464,"80,84",,347,398,207,"52,01",207,207,1413,1257,"88,96",26,26
290480,CAATIBA,BA,06/2022,1750,1358,"77,60",,392,390,185,"47,44",185,185,1360,1173,"86,25",35,35
290485,CABACEIRAS DO PARAGUAÇU,BA,06/2022,6937,6691,"96,45",14,232,1601,1447,"90,38",1447,1447,5336,5244,"98,28",121,121
290485,CABACEIRAS DO PARAGUAÇU,BA,12/2022,6818,6566,"96,30",32,220,1509,1351,"89,53",1351,1351,5309,5215,"98,23",133,133
290490,CACHOEIRA,BA,06/2022,9933,7456,"75,06",,2477,2193,892,"40,67",892,892,7740,6564,"84,81",194,194
290490,CACHOEIRA,BA,12/2022,10083,8149,"80,82",7,1927,2103,1063,"50,55",1063,1063,7980,7086,"88,80",189,189
290500,CACULÉ,BA,12/2022,3902,3484,"89,29",109,309,859,580,"67,52",580,580,3043,2904,"95,43",80,80
290500,CACULÉ,BA,06/2022,3967,3600,"90,75",23,344,851,620,"72,86",620,620,3116,2980,"95,64",85,85
290510,CAÉM,BA,06/2022,4035,3179,"78,79",,856,993,498,"50,15",498,498,3042,2681,"88,13",61,61
290510,CAÉM,BA,12/2022,4088,3460,"84,64",,628,950,566,"59,58",566,566,3138,2894,"92,22",73,73
290515,CAETANOS,BA,06/2022,4594,3624,"78,89",,970,931,427,"45,86",427,427,3663,3197,"87,28",72,72
290515,CAETANOS,BA,12/2022,4574,3899,"85,24",,675,856,504,"58,88",504,504,3718,3395,"91,31",85,85
290520,CAETITÉ,BA,06/2022,10485,5799,"55,31",,4686,2533,329,"12,99",329,329,7952,5470,"68,79",292,292
290520,CAETITÉ,BA,12/2022,11353,8654,"76,23",5,2694,2516,1363,"54,17",1363,1363,8837,7291,"82,51",284,284
290530,CAFARNAUM,BA,12/2022,6453,5895,"91,35",1,557,1442,1124,"77,95",1124,1124,5011,4771,"95,21",124,124
290530,CAFARNAUM,BA,06/2022,6506,5798,"89,12",,708,1549,1183,"76,37",1183,1183,4957,4615,"93,10",141,141
290540,CAIRU,BA,06/2022,5105,4481,"87,78",68,556,1212,837,"69,06",832,837,3893,3644,"93,60",121,121
290540,CAIRU,BA,12/2022,5351,4791,"89,53",167,393,1220,895,"73,36",893,895,4131,3896,"94,31",121,121
290550,CALDEIRÃO GRANDE,BA,12/2022,5300,4253,"80,25",3,1044,1358,781,"57,51",781,781,3942,3472,"88,08",81,81
290550,CALDEIRÃO GRANDE,BA,06/2022,5307,3632,"68,44",1,1674,1444,500,"34,63",500,500,3863,3132,"81,08",121,121
290560,CAMACAN,BA,12/2022,6534,5572,"85,28",904,58,1445,839,"58,06",837,839,5089,4733,"93,00",111,111
290560,CAMACAN,BA,06/2022,6388,5212,"81,59",922,254,1386,641,"46,25",640,641,5002,4571,"91,38",114,114
290570,CAMAÇARI,BA,12/2022,55864,38481,"68,88",1,17382,11345,3764,"33,18",3764,3728,44519,34717,"77,98",1054,1054
290570,CAMAÇARI,BA,06/2022,49559,27934,"56,37",,21625,11856,2377,"20,05",2376,2319,37703,25557,"67,79",1008,1008
290580,CAMAMU,BA,12/2022,11667,9058,"77,64",37,2572,3207,1739,"54,23",1737,1295,8460,7319,"86,51",316,315
290580,CAMAMU,BA,06/2022,11894,10155,"85,38",8,1731,3340,2335,"69,91",2334,1117,8554,7820,"91,42",295,295
290590,CAMPO ALEGRE DE LOURDES,BA,06/2022,9836,9034,"91,85",537,265,2428,2057,"84,72",2057,2057,7408,6977,"94,18",214,214
290590,CAMPO ALEGRE DE LOURDES,BA,12/2022,9887,9221,"93,26",446,220,2382,2038,"85,56",2038,2038,7505,7183,"95,71",222,222
290600,CAMPO FORMOSO,BA,12/2022,23960,20192,"84,27",,3768,5652,3868,"68,44",3868,3868,18308,16324,"89,16",604,604
290600,CAMPO FORMOSO,BA,06/2022,24219,20095,"82,97",,4124,5933,4058,"68,40",4058,4058,18286,16037,"87,70",594,594
290610,CANÁPOLIS,BA,12/2022,2913,2551,"87,57",8,354,708,466,"65,82",466,466,2205,2085,"94,56",56,56
290610,CANÁPOLIS,BA,06/2022,2834,2203,"77,73",8,623,723,338,"46,75",338,338,2111,1865,"88,35",79,79
290620,CANARANA,BA,12/2022,8313,7197,"86,58",,1116,1882,1134,"60,26",1134,1134,6431,6063,"94,28",184,184
290620,CANARANA,BA,06/2022,8157,6485,"79,50",,1672,1903,790,"41,51",790,790,6254,5695,"91,06",172,172
290630,CANAVIEIRAS,BA,12/2022,10001,6899,"68,98",,3102,2320,711,"30,65",711,711,7681,6188,"80,56",259,259
290630,CANAVIEIRAS,BA,06/2022,9623,5946,"61,79",3,3674,2439,697,"28,58",697,697,7184,5249,"73,07",221,221
290640,CANDEAL,BA,12/2022,2880,2640,"91,67",2,238,624,472,"75,64",472,472,2256,2168,"96,10",72,72
290640,CANDEAL,BA,06/2022,2939,2675,"91,02",8,256,655,504,"76,95",504,504,2284,2171,"95,05",84,84
290650,CANDEIAS,BA,06/2022,16563,15319,"92,49",4,1240,3818,3034,"79,47",3034,3033,12745,12285,"96,39",308,308
290650,CANDEIAS,BA,12/2022,18706,18473,"98,75",1,232,3815,3727,"97,69",3727,3727,14891,14746,"99,03",285,285
290660,CANDIBA,BA,12/2022,3920,3415,"87,12",2,503,833,507,"60,86",507,507,3087,2908,"94,20",58,58
290660,CANDIBA,BA,06/2022,4027,3299,"81,92",,728,876,396,"45,21",396,396,3151,2903,"92,13",55,55
290670,CÂNDIDO SALES,BA,06/2022,8623,7125,"82,63",4,1494,1766,997,"56,46",997,997,6857,6128,"89,37",166,166
290670,CÂNDIDO SALES,BA,12/2022,8997,7904,"87,85",401,692,1735,1151,"66,34",1149,1151,7262,6753,"92,99",177,177
290680,CANSANÇÃO,BA,06/2022,13725,12509,"91,14",519,697,3102,2402,"77,43",2399,2399,10623,10107,"95,14",223,223
290680,CANSANÇÃO,BA,12/2022,13600,12429,"91,39",536,635,3012,2331,"77,39",2330,2329,10588,10098,"95,37",288,288
290682,CANUDOS,BA,12/2022,5955,5377,"90,29",7,571,1457,1177,"80,78",1174,1177,4498,4200,"93,37",145,145
290682,CANUDOS,BA,06/2022,5921,5309,"89,66",10,602,1481,1202,"81,16",1199,1201,4440,4107,"92,50",138,138
290685,CAPELA DO ALTO ALEGRE,BA,06/2022,2692,2168,"80,53",,524,561,345,"61,50",345,345,2131,1823,"85,55",60,60
290685,CAPELA DO ALTO ALEGRE,BA,12/2022,2740,2358,"86,06",,382,565,385,"68,14",385,385,2175,1973,"90,71",47,47
290687,CAPIM GROSSO,BA,06/2022,7762,6431,"82,85",16,1315,1884,1188,"63,06",1188,1187,5878,5243,"89,20",132,132
290687,CAPIM GROSSO,BA,12/2022,8423,7196,"85,43",5,1222,1910,1180,"61,78",1180,1180,6513,6016,"92,37",157,157
290689,CARAÍBAS,BA,12/2022,2827,2330,"82,42",3,494,578,325,"56,23",325,325,2249,2005,"89,15",45,45
290689,CARAÍBAS,BA,06/2022,2860,2220,"77,62",7,633,611,280,"45,83",280,280,2249,1940,"86,26",43,43
290690,CARAVELAS,BA,06/2022,6375,5793,"90,87",,582,1410,1068,"75,74",1068,1068,4965,4725,"95,17",141,141
290690,CARAVELAS,BA,12/2022,6581,5980,"90,87",,601,1445,1083,"74,95",1083,1083,5136,4897,"95,35",170,170
290700,CARDEAL DA SILVA,BA,06/2022,3984,3568,"89,56",54,362,921,710,"77,09",710,710,3063,2858,"93,31",95,95
290700,CARDEAL DA SILVA,BA,12/2022,4015,3732,"92,95",67,216,887,724,"81,62",724,724,3128,3008,"96,16",70,70
290710,CARINHANHA,BA,06/2022,10048,8392,"83,52",213,1443,2781,1962,"70,55",1962,1962,7267,6430,"88,48",241,241
290710,CARINHANHA,BA,12/2022,11065,9516,"86,00",404,1145,2672,1893,"70,85",1893,1893,8393,7623,"90,83",290,290
290720,CASA NOVA,BA,06/2022,21170,16041,"75,77",2,5127,5838,3661,"62,71",3660,3568,15332,12380,"80,75",688,688
290720,CASA NOVA,BA,12/2022,21375,16755,"78,39",,4620,5671,3630,"64,01",3630,3536,15704,13125,"83,58",640,640
290730,CASTRO ALVES,BA,12/2022,8163,7501,"91,89",59,603,1610,1251,"77,70",1249,1247,6553,6250,"95,38",169,169
290730,CASTRO ALVES,BA,06/2022,8176,6968,"85,23",5,1203,1669,966,"57,88",966,941,6507,6002,"92,24",178,178
290740,CATOLÂNDIA,BA,06/2022,1274,1067,"83,75",,207,346,217,"62,72",217,217,928,850,"91,59",43,43
290740,CATOLÂNDIA,BA,12/2022,1194,801,"67,09",,393,317,40,"12,62",40,40,877,761,"86,77",21,21
290750,CATU,BA,06/2022,12161,9021,"74,18",6,3134,2276,849,"37,30",848,848,9885,8172,"82,67",214,214
290750,CATU,BA,12/2022,13141,11489,"87,43",30,1622,2142,1382,"64,52",1382,1381,10999,10107,"91,89",250,250
290755,CATURAMA,BA,12/2022,2090,1812,"86,70",10,268,447,305,"68,23",305,305,1643,1507,"91,72",35,35
290755,CATURAMA,BA,06/2022,2109,1801,"85,40",21,287,465,324,"69,68",324,324,1644,1477,"89,84",43,43
290760,CENTRAL,BA,12/2022,4105,3588,"87,41",,517,1003,683,"68,10",683,683,3102,2905,"93,65",82,82
290760,CENTRAL,BA,06/2022,3845,3167,"82,37",,678,998,675,"67,64",675,675,2847,2492,"87,53",84,84
290770,CHORROCHÓ,BA,12/2022,4117,3601,"87,47",,516,983,729,"74,16",729,729,3134,2872,"91,64",79,79
290770,CHORROCHÓ,BA,06/2022,4043,3112,"76,97",,931,1059,580,"54,77",580,580,2984,2532,"84,85",109,109
290780,CÍCERO DANTAS,BA,06/2022,8821,7122,"80,74",,1699,1796,1292,"71,94",1292,1292,7025,5830,"82,99",183,183
290780,CÍCERO DANTAS,BA,12/2022,8475,6402,"75,54",,2073,1765,1162,"65,84",1162,1162,6710,5240,"78,09",167,167
290790,CIPÓ,BA,12/2022,6450,5625,"87,21",7,818,1521,1104,"72,58",1104,1104,4929,4521,"91,72",152,152
290790,CIPÓ,BA,06/2022,6410,5451,"85,04",18,941,1583,1111,"70,18",1111,1111,4827,4340,"89,91",161,161
290800,COARACI,BA,06/2022,6013,4604,"76,57",264,1145,1350,606,"44,89",606,603,4663,3998,"85,74",112,112
290800,COARACI,BA,12/2022,5798,4543,"78,35",225,1030,1253,558,"44,53",558,551,4545,3985,"87,68",105,105
290810,COCOS,BA,12/2022,5581,3681,"65,96",20,1880,1331,338,"25,39",338,338,4250,3343,"78,66",145,145
290810,COCOS,BA,06/2022,5566,3562,"64,00",10,1994,1356,331,"24,41",331,331,4210,3231,"76,75",153,153
290820,CONCEIÇÃO DA FEIRA,BA,12/2022,6796,6068,"89,29",1,727,1311,918,"70,02",917,918,5485,5150,"93,89",100,100
290820,CONCEIÇÃO DA FEIRA,BA,06/2022,6876,5977,"86,93",,899,1396,884,"63,32",884,884,5480,5093,"92,94",104,104
290830,CONCEIÇÃO DO ALMEIDA,BA,12/2022,4936,4547,"92,12",212,177,855,630,"73,68",628,628,4081,3917,"95,98",73,73
290830,CONCEIÇÃO DO ALMEIDA,BA,06/2022,5033,4576,"90,92",250,207,904,633,"70,02",633,633,4129,3943,"95,50",98,98
290840,CONCEIÇÃO DO COITÉ,BA,06/2022,20088,16842,"83,84",3,3243,4377,2907,"66,42",2907,2907,15711,13935,"88,70",298,298
290840,CONCEIÇÃO DO COITÉ,BA,12/2022,20283,17710,"87,31",154,2419,4221,3072,"72,78",3066,3054,16062,14638,"91,13",315,315
290850,CONCEIÇÃO DO JACUÍPE,BA,12/2022,9142,7482,"81,84",36,1624,1633,905,"55,42",905,905,7509,6577,"87,59",159,159
290850,CONCEIÇÃO DO JACUÍPE,BA,06/2022,8861,6259,"70,64",24,2578,1794,650,"36,23",650,643,7067,5609,"79,37",134,134
290860,CONDE,BA,12/2022,9448,8821,"93,36",465,162,2192,1801,"82,16",1801,1796,7256,7020,"96,75",219,219
290860,CONDE,BA,06/2022,9019,7717,"85,56",419,883,2323,1585,"68,23",1585,1556,6696,6132,"91,58",213,213
290870,CONDEÚBA,BA,12/2022,4537,3867,"85,23",2,668,931,556,"59,72",556,556,3606,3311,"91,82",76,76
290870,CONDEÚBA,BA,06/2022,4546,3864,"85,00",6,676,939,569,"60,60",568,568,3607,3295,"91,35",84,84
290880,CONTENDAS DO SINCORÁ,BA,06/2022,1409,1225,"86,94",,184,311,202,"64,95",202,202,1098,1023,"93,17",23,23
290880,CONTENDAS DO SINCORÁ,BA,12/2022,1383,1221,"88,29",,162,299,200,"66,89",200,200,1084,1021,"94,19",35,35
290890,CORAÇÃO DE MARIA,BA,06/2022,9698,8065,"83,16",124,1509,2049,1203,"58,71",1202,1047,7649,6862,"89,71",157,157
290890,CORAÇÃO DE MARIA,BA,12/2022,9606,8055,"83,85",182,1369,1906,1129,"59,23",1129,1087,7700,6926,"89,95",175,175
290900,CORDEIROS,BA,12/2022,2114,1862,"88,08",69,183,468,294,"62,82",294,294,1646,1568,"95,26",44,44
290900,CORDEIROS,BA,06/2022,2102,1593,"75,78",2,507,453,100,"22,08",100,100,1649,1493,"90,54",45,45
290910,CORIBE,BA,06/2022,4725,3438,"72,76",115,1172,1085,362,"33,36",362,362,3640,3076,"84,51",88,88
290910,CORIBE,BA,12/2022,4722,3804,"80,56",47,871,1032,557,"53,97",557,556,3690,3247,"87,99",95,95
290920,CORONEL JOÃO SÁ,BA,12/2022,6329,4823,"76,20",,1506,1401,576,"41,11",576,576,4928,4247,"86,18",127,127
290920,CORONEL JOÃO SÁ,BA,06/2022,6218,4097,"65,89",,2121,1440,234,"16,25",234,234,4778,3863,"80,85",126,126
290930,CORRENTINA,BA,12/2022,8219,5891,"71,68",2,2326,2052,838,"40,84",838,838,6167,5053,"81,94",196,196
290930,CORRENTINA,BA,06/2022,8204,4705,"57,35",,3499,2085,54,"2,59",54,53,6119,4651,"76,01",198,198
290940,COTEGIPE,BA,12/2022,4758,4082,"85,79",,676,1139,760,"66,73",760,760,3619,3322,"91,79",110,110
290940,COTEGIPE,BA,06/2022,4868,3981,"81,78",18,869,1211,723,"59,70",723,723,3657,3258,"89,09",97,97
290950,CRAVOLÂNDIA,BA,06/2022,1446,1148,"79,39",82,216,353,172,"48,73",172,172,1093,976,"89,30",26,26
290950,CRAVOLÂNDIA,BA,12/2022,1397,1106,"79,17",42,249,344,159,"46,22",155,159,1053,947,"89,93",21,21
290960,CRISÓPOLIS,BA,12/2022,6838,5855,"85,62",53,930,1533,1118,"72,93",1118,1118,5305,4737,"89,29",148,148
290960,CRISÓPOLIS,BA,06/2022,6876,5872,"85,40",60,944,1599,1197,"74,86",1197,1197,5277,4675,"88,59",149,149
290970,CRISTÓPOLIS,BA,06/2022,3842,2991,"77,85",14,837,856,296,"34,58",296,296,2986,2695,"90,25",91,91
290970,CRISTÓPOLIS,BA,12/2022,3955,3695,"93,43",61,199,825,663,"80,36",663,663,3130,3032,"96,87",88,88
290980,CRUZ DAS ALMAS,BA,06/2022,12436,9157,"73,63",2,3277,2621,848,"32,35",848,848,9815,8309,"84,66",212,212
290980,CRUZ DAS ALMAS,BA,12/2022,13714,12350,"90,05",,1364,2534,1926,"76,01",1925,1926,11180,10424,"93,24",233,233
290990,CURAÇÁ,BA,12/2022,11003,6333,"57,56",,4670,3019,204,"6,76",204,204,7984,6129,"76,77",227,227
290990,CURAÇÁ,BA,06/2022,10765,5832,"54,18",,4933,3116,322,"10,33",322,322,7649,5510,"72,04",247,247
291000,DÁRIO MEIRA,BA,06/2022,3876,3104,"80,08",30,742,998,628,"62,93",628,628,2878,2476,"86,03",77,77
291000,DÁRIO MEIRA,BA,12/2022,3828,3251,"84,93",3,574,950,673,"70,84",671,673,2878,2578,"89,58",97,97
291005,DIAS D´ÁVILA,BA,06/2022,18770,12593,"67,09",,6177,4458,1811,"40,62",1811,1811,14312,10782,"75,34",424,424
291005,DIAS D´ÁVILA,BA,12/2022,20613,16138,"78,29",,4475,4395,2547,"57,95",2547,2547,16218,13591,"83,80",421,420
291010,DOM BASÍLIO,BA,12/2022,3235,3209,"99,20",26,,657,644,"98,02",644,644,2578,2565,"99,50",51,51
291010,DOM BASÍLIO,BA,06/2022,3259,3228,"99,05",31,,664,648,"97,59",648,648,2595,2580,"99,42",51,51
291020,DOM MACEDO COSTA,BA,06/2022,1159,1082,"93,36",16,61,215,172,"80,00",172,172,944,910,"96,40",26,26
291020,DOM MACEDO COSTA,BA,12/2022,1163,1074,"92,35",1,88,212,152,"71,70",152,151,951,922,"96,95",23,23
291030,ELÍSIO MEDRADO,BA,12/2022,1943,1858,"95,63",6,79,415,367,"88,43",367,367,1528,1491,"97,58",34,34
291030,ELÍSIO MEDRADO,BA,06/2022,1868,1741,"93,20",3,124,406,341,"83,99",341,341,1462,1400,"95,76",30,30
291040,ENCRUZILHADA,BA,06/2022,5881,3658,"62,20",6,2217,1470,405,"27,55",405,405,4411,3253,"73,75",98,98
291040,ENCRUZILHADA,BA,12/2022,6078,4545,"74,78",,1533,1436,655,"45,61",655,655,4642,3890,"83,80",109,109
291050,ENTRE RIOS,BA,06/2022,10658,8760,"82,19",131,1767,2316,1422,"61,40",1422,1422,8342,7338,"87,96",253,253
291050,ENTRE RIOS,BA,12/2022,12118,10856,"89,59",111,1151,2425,1827,"75,34",1827,1827,9693,9029,"93,15",295,295
291060,ESPLANADA,BA,12/2022,10247,8336,"81,35",,1911,2484,1515,"60,99",1514,1515,7763,6821,"87,87",271,271
291060,ESPLANADA,BA,06/2022,9388,6665,"70,99",29,2694,2456,1137,"46,29",1137,1137,6932,5528,"79,75",241,240
291070,EUCLIDES DA CUNHA,BA,12/2022,18869,17134,"90,81",40,1695,4093,3367,"82,26",3332,3109,14776,13767,"93,17",442,442
291070,EUCLIDES DA CUNHA,BA,06/2022,18983,17678,"93,13",43,1262,4123,3624,"87,90",3607,3192,14860,14054,"94,58",420,419
291072,EUNÁPOLIS,BA,06/2022,20501,12401,"60,49",1,8099,6045,2384,"39,44",2384,2384,14456,10017,"69,29",586,586
291072,EUNÁPOLIS,BA,12/2022,22150,15988,"72,18",201,5961,5951,3215,"54,02",3213,3215,16199,12773,"78,85",538,538
291075,FÁTIMA,BA,12/2022,6029,5104,"84,66",1,924,1203,671,"55,78",671,671,4826,4433,"91,86",107,107
291075,FÁTIMA,BA,06/2022,5884,4353,"73,98",,1531,1252,385,"30,75",385,385,4632,3968,"85,66",134,134
291077,FEIRA DA MATA,BA,12/2022,1664,1560,"93,75",37,67,394,325,"82,49",325,325,1270,1235,"97,24",30,30
291077,FEIRA DA MATA,BA,06/2022,1662,1463,"88,03",,199,416,272,"65,38",272,272,1246,1191,"95,59",25,25
291080,FEIRA DE SANTANA,BA,06/2022,100206,72939,"72,79",1782,25485,25410,13571,"53,41",13557,13471,74796,59368,"79,37",2063,2061
291080,FEIRA DE SANTANA,BA,12/2022,112659,86036,"76,37",2386,24237,26855,15199,"56,60",15184,15111,85804,70837,"82,56",2573,2572
291085,FILADÉLFIA,BA,12/2022,6343,5902,"93,05",,441,1382,1138,"82,34",1138,1138,4961,4764,"96,03",109,109
291085,FILADÉLFIA,BA,06/2022,5951,4036,"67,82",1,1914,1432,551,"38,48",551,551,4519,3485,"77,12",142,142
291090,FIRMINO ALVES,BA,06/2022,1625,1259,"77,48",83,283,368,161,"43,75",159,161,1257,1098,"87,35",24,24
291090,FIRMINO ALVES,BA,12/2022,1653,1280,"77,43",10,363,357,123,"34,45",123,123,1296,1157,"89,27",25,25
291100,FLORESTA AZUL,BA,06/2022,2872,2510,"87,40",34,328,564,353,"62,59",353,353,2308,2157,"93,46",42,42
291100,FLORESTA AZUL,BA,12/2022,2774,1896,"68,35",2,876,560,22,"3,93",22,22,2214,1874,"84,64",40,40
291110,FORMOSA DO RIO PRETO,BA,12/2022,7576,5338,"70,46",626,1612,2081,1003,"48,20",1003,997,5495,4335,"78,89",222,222
291110,FORMOSA DO RIO PRETO,BA,06/2022,7314,3713,"50,77",7,3594,2186,324,"14,82",324,324,5128,3389,"66,09",201,201
291120,GANDU,BA,12/2022,8660,6976,"80,55",4,1680,1761,985,"55,93",979,985,6899,5991,"86,84",168,168
291120,GANDU,BA,06/2022,8511,6548,"76,94",1,1962,1911,1052,"55,05",1051,1050,6600,5496,"83,27",181,181
291125,GAVIÃO,BA,12/2022,1620,1471,"90,80",15,134,310,243,"78,39",243,243,1310,1228,"93,74",26,26
291125,GAVIÃO,BA,06/2022,1572,1360,"86,51",,212,327,226,"69,11",226,226,1245,1134,"91,08",19,19
291130,GENTIO DO OURO,BA,06/2022,3424,3293,"96,17",30,101,737,665,"90,23",665,584,2687,2628,"97,80",60,60
291130,GENTIO DO OURO,BA,12/2022,3392,3216,"94,81",23,153,756,661,"87,43",661,661,2636,2555,"96,93",75,75
291140,GLÓRIA,BA,12/2022,4528,4024,"88,87",,504,1145,880,"76,86",880,880,3383,3144,"92,94",84,84
291140,GLÓRIA,BA,06/2022,4685,4162,"88,84",,523,1155,847,"73,33",847,847,3530,3315,"93,91",95,95
291150,GONGOGI,BA,12/2022,2742,2741,"99,96",,1,595,595,"100,00",595,595,2147,2146,"99,95",50,50
291150,GONGOGI,BA,06/2022,2777,2673,"96,25",,104,630,574,"91,11",574,574,2147,2099,"97,76",49,49
291160,GOVERNADOR MANGABEIRA,BA,12/2022,5908,5272,"89,23",12,624,1082,666,"61,55",666,666,4826,4606,"95,44",64,64
291160,GOVERNADOR MANGABEIRA,BA,06/2022,5390,3698,"68,61",10,1682,1075,65,"6,05",65,65,4315,3633,"84,19",75,75
291165,GUAJERU,BA,06/2022,2065,1978,"95,79",66,21,405,355,"87,65",355,355,1660,1623,"97,77",39,39
291165,GUAJERU,BA,12/2022,1902,1836,"96,53",55,11,372,323,"86,83",323,323,1530,1513,"98,89",35,35
291170,GUANAMBI,BA,12/2022,20342,16081,"79,05",41,4220,4185,2022,"48,32",2022,2022,16157,14059,"87,01",315,315
291170,GUANAMBI,BA,06/2022,19201,12967,"67,53",14,6220,4220,951,"22,54",951,951,14981,12016,"80,21",280,280
291180,GUARATINGA,BA,12/2022,6394,4559,"71,30",,1835,1447,352,"24,33",352,352,4947,4207,"85,04",181,181
291180,GUARATINGA,BA,06/2022,6135,4141,"67,50",,1994,1435,231,"16,10",231,231,4700,3910,"83,19",175,175
291185,HELIÓPOLIS,BA,06/2022,3805,3174,"83,42",,631,728,326,"44,78",325,326,3077,2848,"92,56",108,108
291185,HELIÓPOLIS,BA,12/2022,3842,3318,"86,36",,524,754,473,"62,73",473,473,3088,2845,"92,13",91,91
291190,IAÇU,BA,06/2022,8815,7060,"80,09",64,1691,2072,1041,"50,24",1038,1040,6743,6019,"89,26",187,187
291190,IAÇU,BA,12/2022,8904,7860,"88,27",271,773,1927,1324,"68,71",1324,1323,6977,6536,"93,68",223,223
291200,IBIASSUCÊ,BA,12/2022,2423,2264,"93,44",12,147,429,338,"78,79",338,338,1994,1926,"96,59",33,33
291200,IBIASSUCÊ,BA,06/2022,2372,1863,"78,54",,509,433,127,"29,33",127,127,1939,1736,"89,53",37,37
291210,IBICARAÍ,BA,06/2022,6667,5275,"79,12",151,1241,1346,423,"31,43",423,422,5321,4852,"91,19",83,83
291210,IBICARAÍ,BA,12/2022,6993,6159,"88,07",399,435,1325,677,"51,09",677,676,5668,5482,"96,72",99,99
291220,IBICOARA,BA,06/2022,6032,5414,"89,75",51,567,1389,1020,"73,43",1019,1011,4643,4394,"94,64",123,123
291220,IBICOARA,BA,12/2022,5975,5312,"88,90",1,662,1302,909,"69,82",909,909,4673,4403,"94,22",136,136
291230,IBICUÍ,BA,06/2022,4566,3189,"69,84",,1377,928,94,"10,13",94,94,3638,3095,"85,07",67,67
291230,IBICUÍ,BA,12/2022,4684,3867,"82,56",179,638,876,391,"44,63",391,391,3808,3476,"91,28",74,74
291240,IBIPEBA,BA,12/2022,5120,4730,"92,38",244,146,1053,838,"79,58",838,838,4067,3892,"95,70",109,109
291240,IBIPEBA,BA,06/2022,4982,4521,"90,75",245,216,969,747,"77,09",747,747,4013,3774,"94,04",90,90
291250,IBIPITANGA,BA,06/2022,3367,2909,"86,40",,458,685,460,"67,15",460,460,2682,2449,"91,31",56,56
291250,IBIPITANGA,BA,12/2022,3320,3049,"91,84",,271,656,527,"80,34",527,527,2664,2522,"94,67",77,77
291260,IBIQUERA,BA,12/2022,1564,1535,"98,15",,29,365,354,"96,99",354,354,1199,1181,"98,50",24,24
291260,IBIQUERA,BA,06/2022,1413,975,"69,00",,438,369,120,"32,52",120,120,1044,855,"81,90",21,21
291270,IBIRAPITANGA,BA,12/2022,6694,5568,"83,18",1076,50,1775,1033,"58,20",1033,1033,4919,4535,"92,19",169,169
291270,IBIRAPITANGA,BA,06/2022,6347,3667,"57,78",12,2668,1828,137,"7,49",137,137,4519,3530,"78,11",188,187
291280,IBIRAPUÃ,BA,06/2022,2464,1924,"78,08",39,501,637,260,"40,82",260,260,1827,1664,"91,08",68,68
291280,IBIRAPUÃ,BA,12/2022,2578,1974,"76,57",603,1,648,219,"33,80",219,219,1930,1755,"90,93",63,63
291290,IBIRATAIA,BA,06/2022,5425,3972,"73,22",,1453,1302,609,"46,77",609,609,4123,3363,"81,57",119,119
291290,IBIRATAIA,BA,12/2022,5558,4333,"77,96",238,987,1327,684,"51,54",684,684,4231,3649,"86,24",89,89
291300,IBITIARA,BA,12/2022,4216,4125,"97,84",,91,819,772,"94,26",772,772,3397,3353,"98,70",72,72
291300,IBITIARA,BA,06/2022,4194,3878,"92,47",,316,834,645,"77,34",645,645,3360,3233,"96,22",85,85
291310,IBITITÁ,BA,06/2022,5363,2795,"52,12",,2568,1386,225,"16,23",225,225,3977,2570,"64,62",99,99
291310,IBITITÁ,BA,12/2022,5577,3532,"63,33",,2045,1350,313,"23,19",313,313,4227,3219,"76,15",131,131
291320,IBOTIRAMA,BA,12/2022,7143,6114,"85,59",67,962,1756,1096,"62,41",1096,1096,5387,5018,"93,15",136,136
291320,IBOTIRAMA,BA,06/2022,6615,4533,"68,53",4,2078,1585,217,"13,69",217,217,5030,4316,"85,81",147,147
291330,ICHU,BA,06/2022,1987,1648,"82,94",8,331,486,265,"54,53",265,265,1501,1383,"92,14",45,45
291330,ICHU,BA,12/2022,2040,1857,"91,03",42,141,469,345,"73,56",345,345,1571,1512,"96,24",45,45
291340,IGAPORÃ,BA,06/2022,4259,3889,"91,31",36,334,938,717,"76,44",717,717,3321,3172,"95,51",111,111
291340,IGAPORÃ,BA,12/2022,4154,3781,"91,02",20,353,894,671,"75,06",671,671,3260,3110,"95,40",103,103
291345,IGRAPIÚNA,BA,12/2022,4225,2830,"66,98",1,1394,1039,130,"12,51",130,130,3186,2700,"84,75",97,97
291345,IGRAPIÚNA,BA,06/2022,4211,2645,"62,81",,1566,1076,84,"7,81",84,84,3135,2561,"81,69",114,114
291350,IGUAÍ,BA,06/2022,7322,5320,"72,66",12,1990,1721,789,"45,85",789,789,5601,4531,"80,90",130,130
291350,IGUAÍ,BA,12/2022,7341,5648,"76,94",1,1692,1662,825,"49,64",825,825,5679,4823,"84,93",132,132
291360,ILHÉUS,BA,12/2022,36425,22332,"61,31",8,14085,8712,2786,"31,98",2786,2785,27713,19546,"70,53",773,773
291360,ILHÉUS,BA,06/2022,34335,17653,"51,41",11,16671,8930,2053,"22,99",2053,2052,25405,15600,"61,41",598,598
291370,INHAMBUPE,BA,06/2022,10367,7650,"73,79",,2717,2446,1260,"51,51",1260,1260,7921,6390,"80,67",170,170
291370,INHAMBUPE,BA,12/2022,10657,8734,"81,96",,1923,2380,1488,"62,52",1488,1488,8277,7246,"87,54",163,163
291380,IPECAETÁ,BA,12/2022,5164,4938,"95,62",10,216,1141,1012,"88,69",1012,1012,4023,3926,"97,59",129,129
291380,IPECAETÁ,BA,06/2022,4948,4514,"91,23",,434,1139,893,"78,40",893,893,3809,3621,"95,06",125,125
291390,IPIAÚ,BA,06/2022,12359,9868,"79,84",,2491,2521,1276,"50,61",1276,1276,9838,8592,"87,33",595,595
291390,IPIAÚ,BA,12/2022,12745,10507,"82,44",2,2236,2464,1322,"53,65",1322,1322,10281,9185,"89,34",381,381
291400,IPIRÁ,BA,12/2022,16760,14959,"89,25",190,1611,3553,2778,"78,19",2778,2778,13207,12181,"92,23",325,325
291400,IPIRÁ,BA,06/2022,15752,12735,"80,85",5,3012,3592,2262,"62,97",2261,2262,12160,10473,"86,13",299,299
291410,IPUPIARA,BA,06/2022,2794,2157,"77,20",1,636,601,251,"41,76",251,251,2193,1906,"86,91",55,55
291410,IPUPIARA,BA,12/2022,2805,2282,"81,35",,523,565,242,"42,83",242,242,2240,2040,"91,07",51,51
291420,IRAJUBA,BA,06/2022,2081,1575,"75,68",9,497,458,167,"36,46",167,167,1623,1408,"86,75",30,30
291420,IRAJUBA,BA,12/2022,2043,1636,"80,08",9,398,433,182,"42,03",182,182,1610,1454,"90,31",41,41
291430,IRAMAIA,BA,06/2022,2979,1700,"57,07",,1279,707,56,"7,92",56,56,2272,1644,"72,36",63,63
291430,IRAMAIA,BA,12/2022,2970,1829,"61,58",,1141,687,55,"8,01",55,55,2283,1774,"77,70",68,68
291440,IRAQUARA,BA,12/2022,7852,6351,"80,88",6,1495,1914,1157,"60,45",1157,1157,5938,5194,"87,47",181,181
291440,IRAQUARA,BA,06/2022,7491,3928,"52,44",,3563,1991,211,"10,60",211,211,5500,3717,"67,58",182,182
291450,IRARÁ,BA,06/2022,11209,9877,"88,12",27,1305,2466,1811,"73,44",1811,1810,8743,8066,"92,26",207,207
291450,IRARÁ,BA,12/2022,11069,9782,"88,37",55,1232,2246,1599,"71,19",1599,1598,8823,8183,"92,75",203,203
291460,IRECÊ,BA,06/2022,18336,11358,"61,94",,6978,4478,182,"4,06",182,182,13858,11176,"80,65",471,471
291460,IRECÊ,BA,12/2022,19170,13706,"71,50",2,5462,4263,961,"22,54",961,961,14907,12745,"85,50",487,487
291465,ITABELA,BA,12/2022,10331,7855,"76,03",275,2201,2439,1035,"42,44",1035,1035,7892,6820,"86,42",300,300
291465,ITABELA,BA,06/2022,10229,7486,"73,18",168,2575,2521,942,"37,37",942,942,7708,6544,"84,90",285,285
291470,ITABERABA,BA,12/2022,18296,14052,"76,80",,4244,3710,1688,"45,50",1688,1688,14586,12364,"84,77",312,312
291470,ITABERABA,BA,06/2022,16671,9731,"58,37",,6940,3791,347,"9,15",347,347,12880,9384,"72,86",266,266
291480,ITABUNA,BA,06/2022,37963,31717,"83,55",2899,3347,8601,4940,"57,44",4936,4939,29362,26777,"91,20",658,658
291480,ITABUNA,BA,12/2022,39219,31878,"81,28",1848,5493,8258,3711,"44,94",3711,3710,30961,28167,"90,98",692,692
291490,ITACARÉ,BA,06/2022,6554,2987,"45,58",,3567,1891,142,"7,51",142,142,4663,2845,"61,01",121,121
291490,ITACARÉ,BA,12/2022,7499,5398,"71,98",,2101,1876,867,"46,22",867,867,5623,4531,"80,58",149,149
291500,ITAETÉ,BA,12/2022,5845,5031,"86,07",,814,1392,952,"68,39",952,952,4453,4079,"91,60",141,141
291500,ITAETÉ,BA,06/2022,5451,4463,"81,87",,988,1469,979,"66,64",979,979,3982,3484,"87,49",147,147
291510,ITAGI,BA,12/2022,4533,3716,"81,98",86,731,1003,519,"51,74",519,519,3530,3197,"90,57",92,92
291510,ITAGI,BA,06/2022,4378,2878,"65,74",6,1494,1107,188,"16,98",188,188,3271,2690,"82,24",76,76
291520,ITAGIBÁ,BA,06/2022,4173,2746,"65,80",,1427,955,402,"42,09",402,402,3218,2344,"72,84",94,94
291520,ITAGIBÁ,BA,12/2022,4295,2989,"69,59",,1306,964,364,"37,76",364,364,3331,2625,"78,81",97,97
291530,ITAGIMIRIM,BA,12/2022,2233,1821,"81,55",,412,575,341,"59,30",340,341,1658,1480,"89,26",48,48
291530,ITAGIMIRIM,BA,06/2022,2218,1737,"78,31",1,480,608,351,"57,73",351,351,1610,1386,"86,09",47,47
291535,ITAGUAÇU DA BAHIA,BA,06/2022,4708,4195,"89,10",95,418,1185,836,"70,55",836,836,3523,3359,"95,34",137,137
291535,ITAGUAÇU DA BAHIA,BA,12/2022,4828,4512,"93,45",114,202,1205,999,"82,90",999,999,3623,3513,"96,96",134,134
291540,ITAJU DO COLÔNIA,BA,06/2022,2286,1946,"85,13",1,339,593,395,"66,61",395,395,1693,1551,"91,61",42,42
291540,ITAJU DO COLÔNIA,BA,12/2022,2241,1889,"84,29",42,310,559,365,"65,30",365,365,1682,1524,"90,61",28,28
291550,ITAJUÍPE,BA,06/2022,5202,3645,"70,07",4,1553,1289,481,"37,32",481,481,3913,3164,"80,86",102,102
291550,ITAJUÍPE,BA,12/2022,5419,4824,"89,02",17,578,1229,881,"71,68",881,880,4190,3943,"94,11",121,121
291560,ITAMARAJU,BA,12/2022,15642,9524,"60,89",,6118,3923,684,"17,44",684,682,11719,8840,"75,43",314,314
291560,ITAMARAJU,BA,06/2022,15781,9504,"60,22",2,6275,4070,770,"18,92",770,769,11711,8734,"74,58",341,341
291570,ITAMARI,BA,12/2022,2468,1929,"78,16",,539,518,189,"36,49",189,189,1950,1740,"89,23",53,53
291570,ITAMARI,BA,06/2022,2388,1522,"63,74",,866,546,34,"6,23",34,34,1842,1488,"80,78",47,47
291580,ITAMBÉ,BA,06/2022,6645,5840,"87,89",41,764,1655,1274,"76,98",1272,1274,4990,4566,"91,50",140,140
291580,ITAMBÉ,BA,12/2022,6737,5916,"87,81",40,781,1576,1140,"72,34",1139,1140,5161,4776,"92,54",125,125
291590,ITANAGRA,BA,06/2022,2891,2648,"91,59",55,188,674,564,"83,68",559,560,2217,2084,"94,00",79,79
291590,ITANAGRA,BA,12/2022,3007,2783,"92,55",106,118,635,518,"81,57",518,516,2372,2265,"95,49",79,79
291600,ITANHÉM,BA,12/2022,4716,3911,"82,93",27,778,973,578,"59,40",578,578,3743,3333,"89,05",95,95
291600,ITANHÉM,BA,06/2022,4607,3636,"78,92",,971,936,425,"45,41",425,425,3671,3211,"87,47",111,111
291610,ITAPARICA,BA,12/2022,7506,6258,"83,37",24,1224,1409,872,"61,89",870,872,6097,5386,"88,34",130,130
291610,ITAPARICA,BA,06/2022,6744,3472,"51,48",5,3267,1465,59,"4,03",59,59,5279,3413,"64,65",119,119
291620,ITAPÉ,BA,06/2022,3341,2988,"89,43",128,225,700,487,"69,57",487,479,2641,2501,"94,70",67,67
291620,ITAPÉ,BA,12/2022,3278,2884,"87,98",8,386,673,429,"63,74",429,429,2605,2455,"94,24",55,55
291630,ITAPEBI,BA,12/2022,3418,2954,"86,42",10,454,813,554,"68,14",554,554,2605,2400,"92,13",85,85
291630,ITAPEBI,BA,06/2022,3403,2368,"69,59",,1035,865,260,"30,06",260,260,2538,2108,"83,06",101,101
291640,ITAPETINGA,BA,06/2022,13548,8879,"65,54",2,4667,3512,1040,"29,61",1040,1040,10036,7839,"78,11",283,283
291640,ITAPETINGA,BA,12/2022,14508,10519,"72,50",1,3988,3388,1217,"35,92",1215,1217,11120,9302,"83,65",330,330
291650,ITAPICURU,BA,12/2022,11422,9552,"83,63",34,1836,2504,1470,"58,71",1470,1470,8918,8082,"90,63",292,292
291650,ITAPICURU,BA,06/2022,10824,7216,"66,67",120,3488,2514,634,"25,22",634,634,8310,6582,"79,21",282,282
291660,ITAPITANGA,BA,06/2022,1833,1394,"76,05",,439,434,188,"43,32",187,188,1399,1206,"86,20",27,27
291660,ITAPITANGA,BA,12/2022,1827,1469,"80,41",6,352,428,205,"47,90",205,205,1399,1264,"90,35",25,25
291670,ITAQUARA,BA,12/2022,2332,2057,"88,21",,275,510,387,"75,88",387,387,1822,1670,"91,66",50,50
291670,ITAQUARA,BA,06/2022,2311,1823,"78,88",,488,523,316,"60,42",316,316,1788,1507,"84,28",43,43
291680,ITARANTIM,BA,06/2022,4369,3565,"81,60",,804,1003,612,"61,02",612,612,3366,2953,"87,73",98,98
291680,ITARANTIM,BA,12/2022,4452,3965,"89,06",,487,1012,776,"76,68",776,776,3440,3189,"92,70",88,88
291685,ITATIM,BA,06/2022,5735,5733,"99,97",,2,1278,1277,"99,92",1277,1277,4457,4456,"99,98",148,148
291685,ITATIM,BA,12/2022,5788,5788,"100,00",,,1228,1228,"100,00",1228,1228,4560,4560,"100,00",154,154
291690,ITIRUÇU,BA,06/2022,3448,2776,"80,51",79,593,759,413,"54,41",410,413,2689,2363,"87,88",62,61
291690,ITIRUÇU,BA,12/2022,3541,3032,"85,63",157,352,712,454,"63,76",450,454,2829,2578,"91,13",66,66
291700,ITIÚBA,BA,06/2022,11832,10390,"87,81",50,1392,2728,1889,"69,24",1889,1889,9104,8501,"93,38",259,259
291700,ITIÚBA,BA,12/2022,12190,10907,"89,47",41,1242,2749,2033,"73,95",2033,2033,9441,8874,"93,99",307,307
291710,ITORORÓ,BA,06/2022,5032,4178,"83,03",1,853,1152,663,"57,55",663,663,3880,3515,"90,59",96,96
291710,ITORORÓ,BA,12/2022,5055,4325,"85,56",10,720,1062,586,"55,18",586,586,3993,3739,"93,64",100,100
291720,ITUAÇU,BA,12/2022,4988,4729,"94,81",62,197,992,827,"83,37",827,827,3996,3902,"97,65",86,86
291720,ITUAÇU,BA,06/2022,4895,4523,"92,40",61,311,995,790,"79,40",790,790,3900,3733,"95,72",78,78
291730,ITUBERÁ,BA,06/2022,8144,7000,"85,95",399,745,1797,1173,"65,28",1173,1169,6347,5827,"91,81",181,181
291730,ITUBERÁ,BA,12/2022,8319,7388,"88,81",339,592,1682,1171,"69,62",1171,1169,6637,6217,"93,67",184,184
291733,IUIÚ,BA,06/2022,3217,2698,"83,87",,519,715,323,"45,17",323,323,2502,2375,"94,92",39,39
291733,IUIÚ,BA,12/2022,3306,2870,"86,81",15,421,750,437,"58,27",437,437,2556,2433,"95,19",60,60
291735,JABORANDI,BA,12/2022,2957,2835,"95,87",121,1,704,644,"91,48",644,644,2253,2191,"97,25",73,73
291735,JABORANDI,BA,06/2022,3114,2858,"91,78",24,232,732,572,"78,14",572,572,2382,2286,"95,97",82,82
291740,JACARACI,BA,06/2022,3530,3388,"95,98",,142,683,584,"85,51",584,584,2847,2804,"98,49",55,55
291740,JACARACI,BA,12/2022,3420,3300,"96,49",,120,679,595,"87,63",595,595,2741,2705,"98,69",49,49
291750,JACOBINA,BA,06/2022,20156,14974,"74,29",58,5124,5058,2718,"53,74",2718,2718,15098,12256,"81,18",285,285
291750,JACOBINA,BA,12/2022,20513,15663,"76,36",156,4694,4892,2586,"52,86",2586,2585,15621,13077,"83,71",283,283
291760,JAGUAQUARA,BA,12/2022,9776,7523,"76,95",3,2250,2579,1487,"57,66",1487,1487,7197,6036,"83,87",189,189
291760,JAGUAQUARA,BA,06/2022,9431,5942,"63,00",1,3488,2545,775,"30,45",775,775,6886,5167,"75,04",172,172
291770,JAGUARARI,BA,06/2022,8366,7457,"89,13",58,851,1882,1433,"76,14",1348,1085,6484,6024,"92,91",116,116
291770,JAGUARARI,BA,12/2022,8876,8710,"98,13",166,,1861,1799,"96,67",1429,1334,7015,6911,"98,52",137,137
291780,JAGUARIPE,BA,12/2022,6749,5996,"88,84",232,521,1275,871,"68,31",871,870,5474,5125,"93,62",117,117
291780,JAGUARIPE,BA,06/2022,6649,5833,"87,73",411,405,1315,864,"65,70",861,864,5334,4969,"93,16",95,95
291790,JANDAÍRA,BA,12/2022,3850,3396,"88,21",1,453,915,662,"72,35",662,662,2935,2734,"93,15",86,86
291790,JANDAÍRA,BA,06/2022,3767,3288,"87,28",1,478,900,633,"70,33",633,632,2867,2655,"92,61",87,87
291800,JEQUIÉ,BA,06/2022,29217,21617,"73,99",74,7526,6720,2968,"44,17",2858,2730,22497,18649,"82,90",556,555
291800,JEQUIÉ,BA,12/2022,32562,25764,"79,12",45,6753,7142,3978,"55,70",3867,3827,25420,21786,"85,70",668,668
291810,JEREMOABO,BA,06/2022,11882,10155,"85,47",43,1684,2441,1658,"67,92",1658,1658,9441,8497,"90,00",269,269
291810,JEREMOABO,BA,12/2022,11871,9888,"83,30",32,1951,2432,1461,"60,07",1461,1461,9439,8427,"89,28",235,235
291820,JIQUIRIÇÁ,BA,06/2022,4855,4521,"93,12",,334,975,785,"80,51",785,785,3880,3736,"96,29",86,86
291820,JIQUIRIÇÁ,BA,12/2022,4938,4626,"93,68",,312,949,775,"81,66",775,775,3989,3851,"96,54",84,84
291830,JITAÚNA,BA,06/2022,4351,2519,"57,89",1,1831,1095,216,"19,73",216,216,3256,2303,"70,73",110,110
291830,JITAÚNA,BA,12/2022,4308,2632,"61,10",1,1675,1025,156,"15,22",156,156,3283,2476,"75,42",99,99
291835,JOÃO DOURADO,BA,12/2022,7717,5638,"73,06",,2079,2110,937,"44,41",935,937,5607,4701,"83,84",179,179
291835,JOÃO DOURADO,BA,06/2022,7626,5602,"73,46",4,2020,2103,1035,"49,22",1035,1035,5523,4567,"82,69",159,159
291840,JUAZEIRO,BA,06/2022,54800,36531,"66,66",4,18265,14536,5922,"40,74",5922,5920,40264,30609,"76,02",1489,1488
291840,JUAZEIRO,BA,12/2022,59943,48234,"80,47",3,11706,14317,9051,"63,22",9050,9051,45626,39183,"85,88",1576,1576
291845,JUCURUÇU,BA,06/2022,2976,1919,"64,48",,1057,667,140,"20,99",140,140,2309,1779,"77,05",88,88
291845,JUCURUÇU,BA,12/2022,3270,2566,"78,47",1,703,713,335,"46,98",335,335,2557,2231,"87,25",85,85
291850,JUSSARA,BA,06/2022,5572,4861,"87,24",5,706,1306,836,"64,01",836,836,4266,4025,"94,35",103,103
291850,JUSSARA,BA,12/2022,5734,5092,"88,80",5,637,1272,852,"66,98",852,852,4462,4240,"95,02",106,106
291855,JUSSARI,BA,06/2022,1989,1607,"80,79",2,380,478,239,"50,00",239,239,1511,1368,"90,54",51,51
291855,JUSSARI,BA,12/2022,2012,1711,"85,04",13,288,448,265,"59,15",265,265,1564,1446,"92,46",50,50
291860,JUSSIAPE,BA,06/2022,1767,1725,"97,62",17,25,336,308,"91,67",308,308,1431,1417,"99,02",33,33
291860,JUSSIAPE,BA,12/2022,1712,1630,"95,21",11,71,318,259,"81,45",259,259,1394,1371,"98,35",26,26
291870,LAFAIETE COUTINHO,BA,12/2022,1016,682,"67,13",,334,230,27,"11,74",27,27,786,655,"83,33",14,14
291870,LAFAIETE COUTINHO,BA,06/2022,1027,687,"66,89",,340,236,26,"11,02",26,26,791,661,"83,57",18,18
291875,LAGOA REAL,BA,12/2022,3619,3441,"95,08",32,146,784,668,"85,20",668,668,2835,2773,"97,81",87,87
291875,LAGOA REAL,BA,06/2022,3671,3471,"94,55",37,163,832,705,"84,74",705,705,2839,2766,"97,43",73,73
291880,LAJE,BA,06/2022,7146,6478,"90,65",115,553,1523,1218,"79,97",1218,1218,5623,5260,"93,54",140,140
291880,LAJE,BA,12/2022,7294,6705,"91,92",52,537,1478,1176,"79,57",1176,1176,5816,5529,"95,07",149,149
291890,LAJEDÃO,BA,12/2022,1255,755,"60,16",,500,312,22,"7,05",22,22,943,733,"77,73",23,23
291890,LAJEDÃO,BA,06/2022,1309,996,"76,09",,313,309,130,"42,07",130,130,1000,866,"86,60",28,28
291900,LAJEDINHO,BA,12/2022,1274,1139,"89,40",5,130,272,188,"69,12",188,188,1002,951,"94,91",17,17
291900,LAJEDINHO,BA,06/2022,1255,1121,"89,32",1,133,268,184,"68,66",184,184,987,937,"94,93",13,13
291905,LAJEDO DO TABOCAL,BA,12/2022,2332,1803,"77,32",,529,511,249,"48,73",249,249,1821,1554,"85,34",42,42
291905,LAJEDO DO TABOCAL,BA,06/2022,2324,1600,"68,85",23,701,542,171,"31,55",171,171,1782,1429,"80,19",42,42
291910,LAMARÃO,BA,12/2022,3810,3480,"91,34",2,328,792,666,"84,09",666,666,3018,2814,"93,24",92,92
291910,LAMARÃO,BA,06/2022,3609,3089,"85,59",1,519,826,643,"77,85",643,643,2783,2446,"87,89",80,80
291915,LAPÃO,BA,06/2022,7993,5106,"63,88",,2887,1998,184,"9,21",184,184,5995,4922,"82,10",163,163
291915,LAPÃO,BA,12/2022,8253,5508,"66,74",,2745,1991,183,"9,19",183,183,6262,5325,"85,04",128,128
291920,LAURO DE FREITAS,BA,12/2022,34837,25831,"74,15",,9006,7297,3867,"52,99",3867,3866,27540,21964,"79,75",665,665
291920,LAURO DE FREITAS,BA,06/2022,29944,15401,"51,43",1,14542,7481,1189,"15,89",1189,1189,22463,14212,"63,27",463,463
291930,LENÇÓIS,BA,12/2022,3075,2073,"67,41",,1002,731,66,"9,03",66,66,2344,2007,"85,62",64,64
291930,LENÇÓIS,BA,06/2022,2758,1622,"58,81",,1136,646,17,"2,63",17,17,2112,1605,"75,99",56,56
291940,LICÍNIO DE ALMEIDA,BA,06/2022,2803,1933,"68,96",,870,603,76,"12,60",76,76,2200,1857,"84,41",60,60
291940,LICÍNIO DE ALMEIDA,BA,12/2022,2969,2742,"92,35",2,225,582,476,"81,79",476,476,2387,2266,"94,93",60,60
291950,LIVRAMENTO DE NOSSA SENHORA,BA,06/2022,10692,8746,"81,80",3,1943,2381,1184,"49,73",1184,1184,8311,7562,"90,99",224,224
291950,LIVRAMENTO DE NOSSA SENHORA,BA,12/2022,10943,9534,"87,12",4,1405,2347,1527,"65,06",1527,1527,8596,8007,"93,15",232,232
291955,LUÍS EDUARDO MAGALHÃES,BA,12/2022,23090,19867,"86,04",1,3222,5868,4386,"74,74",4386,4386,17222,15481,"89,89",545,545
291955,LUÍS EDUARDO MAGALHÃES,BA,06/2022,19707,11646,"59,10",,8061,6004,2201,"36,66",2200,2201,13703,9445,"68,93",527,527
291960,MACAJUBA,BA,12/2022,3916,3564,"91,01",240,112,874,695,"79,52",695,694,3042,2869,"94,31",74,74
291960,MACAJUBA,BA,06/2022,3903,3595,"92,11",68,240,905,748,"82,65",745,748,2998,2847,"94,96",71,70
291970,MACARANI,BA,06/2022,5074,4051,"79,84",41,982,1211,711,"58,71",711,711,3863,3340,"86,46",94,94
291970,MACARANI,BA,12/2022,5178,4407,"85,11",332,439,1148,748,"65,16",748,748,4030,3659,"90,79",102,102
291980,MACAÚBAS,BA,06/2022,11254,9082,"80,70",97,2075,2672,1495,"55,95",1495,1495,8582,7587,"88,41",260,260
291980,MACAÚBAS,BA,12/2022,11225,9143,"81,45",244,1838,2691,1615,"60,01",1615,1615,8534,7528,"88,21",283,283
291990,MACURURÉ,BA,12/2022,2813,2486,"88,38",,327,700,516,"73,71",516,516,2113,1970,"93,23",55,55
291990,MACURURÉ,BA,06/2022,2792,2363,"84,63",,429,756,544,"71,96",544,544,2036,1819,"89,34",65,65
291992,MADRE DE DEUS,BA,12/2022,4783,4024,"84,13",745,14,913,578,"63,31",578,577,3870,3446,"89,04",72,72
291992,MADRE DE DEUS,BA,06/2022,4410,3228,"73,20",,1182,980,532,"54,29",532,531,3430,2696,"78,60",87,87
291995,MAETINGA,BA,12/2022,2416,2292,"94,87",8,116,451,374,"82,93",374,374,1965,1918,"97,61",52,52
291995,MAETINGA,BA,06/2022,2403,2242,"93,30",17,144,471,385,"81,74",385,385,1932,1857,"96,12",41,41
292000,MAIQUINIQUE,BA,06/2022,2666,2084,"78,17",,582,634,387,"61,04",387,387,2032,1697,"83,51",81,81
292000,MAIQUINIQUE,BA,12/2022,2682,2068,"77,11",8,606,608,354,"58,22",354,354,2074,1714,"82,64",74,74
292010,MAIRI,BA,12/2022,5869,5507,"93,83",115,247,1130,959,"84,87",959,959,4739,4548,"95,97",105,105
292010,MAIRI,BA,06/2022,5618,4316,"76,82",27,1275,1203,529,"43,97",529,529,4415,3787,"85,78",90,90
292020,MALHADA,BA,06/2022,5576,3808,"68,29",38,1730,1428,301,"21,08",301,290,4148,3507,"84,55",149,149
292020,MALHADA,BA,12/2022,5942,5277,"88,81",104,561,1409,1023,"72,60",1023,1023,4533,4254,"93,85",161,161
292030,MALHADA DE PEDRAS,BA,12/2022,2383,2346,"98,45",16,21,468,445,"95,09",445,445,1915,1901,"99,27",60,60
292030,MALHADA DE PEDRAS,BA,06/2022,2296,2239,"97,52",17,40,461,435,"94,36",435,435,1835,1804,"98,31",43,43
292040,MANOEL VITORINO,BA,06/2022,4907,3514,"71,61",1,1392,1137,376,"33,07",376,376,3770,3138,"83,24",106,106
292040,MANOEL VITORINO,BA,12/2022,5145,4651,"90,40",1,493,1063,782,"73,57",782,782,4082,3869,"94,78",100,100
292045,MANSIDÃO,BA,12/2022,4438,3840,"86,53",2,596,1112,767,"68,97",767,767,3326,3073,"92,39",96,96
292045,MANSIDÃO,BA,06/2022,4562,4224,"92,59",99,239,1193,1026,"86,00",1026,1026,3369,3198,"94,92",94,94
292050,MARACÁS,BA,06/2022,6901,5976,"86,60",2,923,1516,972,"64,12",972,972,5385,5004,"92,92",133,133
292050,MARACÁS,BA,12/2022,6936,5957,"85,89",57,922,1491,920,"61,70",920,919,5445,5037,"92,51",99,99
292060,MARAGOGIPE,BA,12/2022,13281,9209,"69,34",,4072,2532,283,"11,18",283,283,10749,8926,"83,04",256,256
292060,MARAGOGIPE,BA,06/2022,12611,7748,"61,44",,4863,2595,132,"5,09",132,132,10016,7616,"76,04",240,240
292070,MARAÚ,BA,06/2022,7100,5382,"75,80",9,1709,1817,900,"49,53",900,900,5283,4482,"84,84",162,162
292070,MARAÚ,BA,12/2022,7260,5716,"78,73",3,1541,1739,885,"50,89",885,885,5521,4831,"87,50",172,172
292080,MARCIONÍLIO SOUZA,BA,12/2022,3773,3202,"84,87",9,562,827,551,"66,63",551,551,2946,2651,"89,99",89,89
292080,MARCIONÍLIO SOUZA,BA,06/2022,3654,2539,"69,49",3,1112,880,356,"40,45",356,356,2774,2183,"78,70",84,84
292090,MASCOTE,BA,06/2022,3944,2818,"71,45",,1126,994,343,"34,51",343,343,2950,2475,"83,90",102,102
292090,MASCOTE,BA,12/2022,3880,2380,"61,34",,1500,957,34,"3,55",34,34,2923,2346,"80,26",96,96
292100,MATA DE SÃO JOÃO,BA,12/2022,13502,11818,"87,53",11,1673,2891,1865,"64,51",1865,1865,10611,9953,"93,80",313,313
292100,MATA DE SÃO JOÃO,BA,06/2022,12910,10123,"78,41",,2787,3018,1369,"45,36",1368,1369,9892,8754,"88,50",307,307
292105,MATINA,BA,06/2022,4230,3951,"93,40",3,276,949,804,"84,72",804,804,3281,3147,"95,92",79,79
292105,MATINA,BA,12/2022,4143,3909,"94,35",6,228,934,802,"85,87",802,802,3209,3107,"96,82",83,83
292110,MEDEIROS NETO,BA,12/2022,5930,4736,"79,87",71,1123,1350,662,"49,04",662,662,4580,4074,"88,95",134,134
292110,MEDEIROS NETO,BA,06/2022,5576,4573,"82,01",92,911,1298,707,"54,47",707,707,4278,3866,"90,37",120,120
292120,MIGUEL CALMON,BA,06/2022,7115,5750,"80,82",,1365,1680,813,"48,39",813,807,5435,4937,"90,84",122,122
292120,MIGUEL CALMON,BA,12/2022,7194,6644,"92,35",,550,1664,1367,"82,15",1353,1367,5530,5277,"95,42",127,127
292130,MILAGRES,BA,12/2022,3809,3332,"87,48",84,393,783,500,"63,86",500,500,3026,2832,"93,59",92,92
292130,MILAGRES,BA,06/2022,3860,3297,"85,41",75,488,838,505,"60,26",505,505,3022,2792,"92,39",81,81
292140,MIRANGABA,BA,06/2022,5812,5095,"87,66",26,691,1352,978,"72,34",978,978,4460,4117,"92,31",154,154
292140,MIRANGABA,BA,12/2022,5841,5112,"87,52",57,672,1306,896,"68,61",896,896,4535,4216,"92,97",135,135
292145,MIRANTE,BA,12/2022,3067,2798,"91,23",,269,616,450,"73,05",450,450,2451,2348,"95,80",58,58
292145,MIRANTE,BA,06/2022,3081,2888,"93,74",,193,597,494,"82,75",494,494,2484,2394,"96,38",65,65
292150,MONTE SANTO,BA,06/2022,17172,14009,"81,58",87,3076,3931,2393,"60,88",2393,2391,13241,11616,"87,73",344,344
292150,MONTE SANTO,BA,12/2022,17011,14603,"85,84",380,2028,3745,2679,"71,54",2676,2678,13266,11924,"89,88",347,347
292160,MORPARÁ,BA,12/2022,2981,2616,"87,76",140,225,712,497,"69,80",497,497,2269,2119,"93,39",80,80
292160,MORPARÁ,BA,06/2022,3029,2208,"72,90",116,705,765,193,"25,23",193,193,2264,2015,"89,00",61,61
292170,MORRO DO CHAPÉU,BA,06/2022,10305,9131,"88,61",2,1172,2577,1902,"73,81",1902,1902,7728,7229,"93,54",268,268
292170,MORRO DO CHAPÉU,BA,12/2022,10412,9403,"90,31",4,1005,2562,1988,"77,60",1988,1988,7850,7415,"94,46",226,226
292180,MORTUGABA,BA,12/2022,2587,2536,"98,03",18,33,564,519,"92,02",519,518,2023,2017,"99,70",40,40
292180,MORTUGABA,BA,06/2022,2619,2292,"87,51",3,324,567,372,"65,61",372,372,2052,1920,"93,57",49,49
292190,MUCUGÊ,BA,06/2022,3165,2435,"76,94",1,729,750,364,"48,53",364,364,2415,2071,"85,76",60,60
292190,MUCUGÊ,BA,12/2022,3431,3147,"91,72",5,279,751,566,"75,37",566,566,2680,2581,"96,31",62,62
292200,MUCURI,BA,12/2022,8605,7122,"82,77",63,1420,2268,1332,"58,73",1318,1332,6337,5790,"91,37",215,215
292200,MUCURI,BA,06/2022,8173,6571,"80,40",114,1488,2206,1162,"52,67",1162,1162,5967,5409,"90,65",180,180
292205,MULUNGU DO MORRO,BA,06/2022,4950,4289,"86,65",,661,1072,682,"63,62",682,682,3878,3607,"93,01",120,120
292205,MULUNGU DO MORRO,BA,12/2022,5149,4902,"95,20",2,245,1074,925,"86,13",925,925,4075,3977,"97,60",104,104
292210,MUNDO NOVO,BA,12/2022,6818,5585,"81,92",1,1232,1454,869,"59,77",869,869,5364,4716,"87,92",135,135
292210,MUNDO NOVO,BA,06/2022,6998,5836,"83,40",,1162,1596,1064,"66,67",1064,1064,5402,4772,"88,34",129,129
292220,MUNIZ FERREIRA,BA,06/2022,2408,2314,"96,10",19,75,453,389,"85,87",389,389,1955,1925,"98,47",37,37
292220,MUNIZ FERREIRA,BA,12/2022,2344,2270,"96,84",10,64,419,369,"88,07",367,369,1925,1901,"98,75",32,32
292225,MUQUÉM DE SÃO FRANCISCO,BA,12/2022,4504,3870,"85,92",270,364,1110,682,"61,44",682,682,3394,3188,"93,93",146,146
292225,MUQUÉM DE SÃO FRANCISCO,BA,06/2022,4540,3856,"84,93",300,384,1168,706,"60,45",706,706,3372,3150,"93,42",110,110
292230,MURITIBA,BA,06/2022,9649,9622,"99,72",,27,2234,2220,"99,37",2220,2220,7415,7402,"99,82",154,154
292230,MURITIBA,BA,12/2022,9575,9484,"99,05",,91,2063,2014,"97,62",2014,2012,7512,7470,"99,44",145,145
292240,MUTUÍPE,BA,12/2022,5845,5415,"92,64",398,32,1274,1012,"79,43",1012,1012,4571,4403,"96,32",91,91
292240,MUTUÍPE,BA,06/2022,5672,4709,"83,02",210,753,1262,613,"48,57",601,612,4410,4096,"92,88",89,89
292250,NAZARÉ,BA,06/2022,6773,4366,"64,46",,2407,1609,440,"27,35",438,440,5164,3926,"76,03",139,139
292250,NAZARÉ,BA,12/2022,7270,5634,"77,50",,1636,1599,802,"50,16",802,802,5671,4832,"85,21",135,135
292260,NILO PEÇANHA,BA,12/2022,4514,3180,"70,45",1,1333,1039,164,"15,78",164,164,3475,3016,"86,79",134,134
292260,NILO PEÇANHA,BA,06/2022,4462,2931,"65,69",,1531,1078,79,"7,33",79,79,3384,2852,"84,28",104,104
292265,NORDESTINA,BA,06/2022,4086,3687,"90,23",65,334,938,697,"74,31",697,697,3148,2990,"94,98",89,89
292265,NORDESTINA,BA,12/2022,4182,3941,"94,24",54,187,917,766,"83,53",766,766,3265,3175,"97,24",113,113
292270,NOVA CANAÃ,BA,12/2022,4454,3738,"83,92",13,703,934,531,"56,85",531,531,3520,3207,"91,11",86,86
292270,NOVA CANAÃ,BA,06/2022,4366,3575,"81,88",38,753,958,556,"58,04",556,556,3408,3019,"88,59",79,79
292273,NOVA FÁTIMA,BA,06/2022,2577,2063,"80,05",,514,558,296,"53,05",296,295,2019,1767,"87,52",62,62
292273,NOVA FÁTIMA,BA,12/2022,2598,1960,"75,44",9,629,521,193,"37,04",193,193,2077,1767,"85,07",54,54
292275,NOVA IBIÁ,BA,12/2022,2030,1794,"88,37",61,175,460,311,"67,61",311,311,1570,1483,"94,46",41,41
292275,NOVA IBIÁ,BA,06/2022,1868,1598,"85,55",11,259,424,244,"57,55",241,244,1444,1354,"93,77",26,26
292280,NOVA ITARANA,BA,06/2022,3102,2801,"90,30",53,248,764,572,"74,87",572,572,2338,2229,"95,34",62,62
292280,NOVA ITARANA,BA,12/2022,3086,2783,"90,18",72,231,724,525,"72,51",525,525,2362,2258,"95,60",52,52
292285,NOVA REDENÇÃO,BA,12/2022,2611,2173,"83,22",5,433,594,355,"59,76",354,355,2017,1818,"90,13",57,57
292285,NOVA REDENÇÃO,BA,06/2022,2658,2138,"80,44",,520,639,343,"53,68",342,343,2019,1795,"88,91",57,57
292290,NOVA SOURE,BA,06/2022,7872,5664,"71,95",,2208,1881,596,"31,69",596,596,5991,5068,"84,59",181,181
292290,NOVA SOURE,BA,12/2022,7991,6427,"80,43",,1564,1773,1176,"66,33",1176,1176,6218,5251,"84,45",155,155
292300,NOVA VIÇOSA,BA,12/2022,11220,9109,"81,19",349,1762,2581,1425,"55,21",1419,1424,8639,7684,"88,95",282,282
292300,NOVA VIÇOSA,BA,06/2022,11267,8762,"77,77",80,2425,2718,1351,"49,71",1349,1349,8549,7411,"86,69",282,282
292303,NOVO HORIZONTE,BA,06/2022,3882,3738,"96,29",17,127,816,725,"88,85",725,725,3066,3013,"98,27",89,89
292303,NOVO HORIZONTE,BA,12/2022,3944,3768,"95,54",27,149,790,679,"85,95",679,679,3154,3089,"97,94",97,97
292305,NOVO TRIUNFO,BA,12/2022,3177,2846,"89,58",1,330,719,498,"69,26",498,384,2458,2348,"95,52",73,73
292305,NOVO TRIUNFO,BA,06/2022,2957,2006,"67,84",,951,716,108,"15,08",108,107,2241,1898,"84,69",72,72
292310,OLINDINA,BA,06/2022,8173,6653,"81,40",322,1198,1804,1128,"62,53",1126,1127,6369,5525,"86,75",174,174
292310,OLINDINA,BA,12/2022,8175,7284,"89,10",231,660,1686,1293,"76,69",1291,1293,6489,5991,"92,33",162,162
292320,OLIVEIRA DOS BREJINHOS,BA,12/2022,6637,5944,"89,56",,693,1496,1026,"68,58",1026,1026,5141,4918,"95,66",140,140
292320,OLIVEIRA DOS BREJINHOS,BA,06/2022,6680,6006,"89,91",,674,1528,1129,"73,89",1129,1129,5152,4877,"94,66",161,161
292330,OURIÇANGAS,BA,06/2022,3018,2809,"93,07",,209,667,559,"83,81",559,559,2351,2250,"95,70",53,53
292330,OURIÇANGAS,BA,12/2022,3077,2849,"92,59",3,225,644,504,"78,26",504,504,2433,2345,"96,38",57,57
292335,OUROLÂNDIA,BA,12/2022,6700,6159,"91,93",44,497,1515,1232,"81,32",1232,1232,5185,4927,"95,02",146,146
292335,OUROLÂNDIA,BA,06/2022,6521,5666,"86,89",29,826,1530,1122,"73,33",1121,1122,4991,4544,"91,04",131,131
292340,PALMAS DE MONTE ALTO,BA,06/2022,6010,5083,"84,58",,927,1236,788,"63,75",788,788,4774,4295,"89,97",98,98
292340,PALMAS DE MONTE ALTO,BA,12/2022,6046,5422,"89,68",1,623,1231,887,"72,06",887,887,4815,4535,"94,18",92,92
292350,PALMEIRAS,BA,12/2022,3314,3114,"93,96",55,145,744,633,"85,08",633,633,2570,2481,"96,54",82,82
292350,PALMEIRAS,BA,06/2022,3176,2887,"90,90",51,238,730,573,"78,49",573,573,2446,2314,"94,60",88,88
292360,PARAMIRIM,BA,06/2022,5291,4599,"86,92",28,664,1032,683,"66,18",683,683,4259,3916,"91,95",78,78
292360,PARAMIRIM,BA,12/2022,5538,4937,"89,15",37,564,1023,709,"69,31",709,709,4515,4228,"93,64",114,114
292370,PARATINGA,BA,12/2022,11937,10337,"86,60",,1600,2909,1937,"66,59",1937,1937,9028,8400,"93,04",339,339
292370,PARATINGA,BA,06/2022,10931,6689,"61,19",1,4241,3052,593,"19,43",593,593,7879,6096,"77,37",268,268
292380,PARIPIRANGA,BA,06/2022,7566,4978,"65,79",,2588,1557,204,"13,10",204,204,6009,4774,"79,45",194,194
292380,PARIPIRANGA,BA,12/2022,8211,7310,"89,03",70,831,1536,1200,"78,13",1182,1200,6675,6110,"91,54",195,195
292390,PAU BRASIL,BA,12/2022,3950,3374,"85,42",2,574,998,678,"67,94",678,678,2952,2696,"91,33",64,64
292390,PAU BRASIL,BA,06/2022,3948,3197,"80,98",2,749,1056,649,"61,46",649,649,2892,2548,"88,11",55,55
292400,PAULO AFONSO,BA,06/2022,28995,25064,"86,44",1416,2515,6684,4621,"69,14",4618,4619,22311,20443,"91,63",621,621
292400,PAULO AFONSO,BA,12/2022,28619,25308,"88,43",1627,1684,6355,4587,"72,18",4586,4583,22264,20721,"93,07",599,599
292405,PÉ DE SERRA,BA,12/2022,4675,4329,"92,60",80,266,972,788,"81,07",788,788,3703,3541,"95,63",128,128
292405,PÉ DE SERRA,BA,06/2022,4645,4164,"89,64",30,451,1024,818,"79,88",818,818,3621,3346,"92,41",127,127
292410,PEDRÃO,BA,06/2022,2663,2376,"89,22",,287,570,395,"69,30",395,395,2093,1981,"94,65",56,56
292410,PEDRÃO,BA,12/2022,2641,2502,"94,74",,139,537,454,"84,54",454,454,2104,2048,"97,34",73,73
292420,PEDRO ALEXANDRE,BA,12/2022,5292,4071,"76,93",,1221,1366,593,"43,41",593,593,3926,3478,"88,59",125,125
292420,PEDRO ALEXANDRE,BA,06/2022,5120,3496,"68,28",,1624,1374,392,"28,53",392,392,3746,3104,"82,86",148,148
292430,PIATÃ,BA,06/2022,5258,4426,"84,18",,832,1174,768,"65,42",768,768,4084,3658,"89,57",96,96
292430,PIATÃ,BA,12/2022,5497,5339,"97,13",,158,1155,1080,"93,51",1080,1080,4342,4259,"98,09",108,108